ACAACGAATAAAAGAGTAGG -> GACTGGGGAGTATTTGGGCT
GACTGGGGAGTATTTGGGCT -> TTGGTTGTACTGCTCAAGTG
TTGGTTGTACTGCTCAAGTG -> CCGATCGCCGAATATGGTAG
CCGATCGCCGAATATGGTAG -> CGATAAGAAAAGGATCCTTA
CGATAAGAAAAGGATCCTTA -> GGCTCGAGGTGAGCTAAACC
GGCTCGAGGTGAGCTAAACC -> GTATCGCAGTTGATATAACT
GTATCGCAGTTGATATAACT -> CGACAACGAATAAAAGAGTA
CGACAACGAATAAAAGAGTA -> TAAAAACCTATTTCTACATA
TAAAAACCTATTTCTACATA -> AGTAGCAACGGGGTGCGATA
AGTAGCAACGGGGTGCGATA -> GATAAGAAAAGGATCCTTAA
GATAAGAAAAGGATCCTTAA -> AGAAAGAAAAATATTATGAC
AGAAAGAAAAATATTATGAC -> TCAGCTACAGACTAGAAAGC
TCAGCTACAGACTAGAAAGC -> GGTAAATTCAAACCCGCGGT
GGTAAATTCAAACCCGCGGT -> GTATCTTAGCCCATAAGAGT
GTATCTTAGCCCATAAGAGT -> AGTTATATGTAGGGTAAATT
AGTTATATGTAGGGTAAATT -> ACTCCATTCGGTGGTACGGC
ACTCCATTCGGTGGTACGGC -> GAATCATATGGGTGCTATGC
GAATCATATGGGTGCTATGC -> CGTTGGAACTGAATACCTGT
CGTTGGAACTGAATACCTGT -> TCTTTCAAGGGGGCTATTAG
TCTTTCAAGGGGGCTATTAG -> GAATACCTGTGAGATGCGAA
GAATACCTGTGAGATGCGAA -> AGCGACTGTGCCGCTAGATG
AGCGACTGTGCCGCTAGATG -> GTAGGTGGTCTTTAAAGGGG
GTAGGTGGTCTTTAAAGGGG -> AGTATTTGGGCTTTTTCCCA
AGTATTTGGGCTTTTTCCCA -> ACCCGCGAACCAATGTGCTA
ACCCGCGAACCAATGTGCTA -> GACGACAACGAATAAAAGAG
GACGACAACGAATAAAAGAG -> TAGACCCTCGCTTGTTTCGT
TAGACCCTCGCTTGTTTCGT -> TGACTGGCGATGCAGGGTAT
TGACTGGCGATGCAGGGTAT -> TTAGGTTACATCGACCTCTT
TTAGGTTACATCGACCTCTT -> CTCTGGCAATGGAACCACAG
CTCTGGCAATGGAACCACAG -> GTAGGAGTTAGATGTTTTAG
GTAGGAGTTAGATGTTTTAG -> CGCCTATCTGGGGCTTCCAC
CGCCTATCTGGGGCTTCCAC -> GTAGGCATCAAACGAACGCA
GTAGGCATCAAACGAACGCA -> ACCTGTTTCACCCAATCCGG
ACCTGTTTCACCCAATCCGG -> CACATAACAGCCAGCAAGTA
CACATAACAGCCAGCAAGTA -> TGCCGCTAGATGGCTCGAGG
TGCCGCTAGATGGCTCGAGG -> CCGACGCGGGGACGAGGCGC
CCGACGCGGGGACGAGGCGC -> ACCTATTTCTACATAGAAGC
ACCTATTTCTACATAGAAGC -> TGGTAGACCCTCGCTTGTTT
TGGTAGACCCTCGCTTGTTT -> CTTAAAGATCATTGAGAAAG
CTTAAAGATCATTGAGAAAG -> ACGTCCGATCGCCGAATATG
ACGTCCGATCGCCGAATATG -> GCAGCTCTTGTCGGCTGGTC
GCAGCTCTTGTCGGCTGGTC -> GCCGAATATGGTAGACCCTC
GCCGAATATGGTAGACCCTC -> GTTCTCACCCGGACTCTGAC
GTTCTCACCCGGACTCTGAC -> CCCAGGTGGGCATTTAACGC
CCCAGGTGGGCATTTAACGC -> TGTAAAAACCTATTTCTACA
TGTAAAAACCTATTTCTACA -> ACCACCCGCGAACCAATGTG
ACCACCCGCGAACCAATGTG -> TAAATTCAAACCCGCGGTAT
TAAATTCAAACCCGCGGTAT -> AGCAACGGGGTGCGATAAGA
AGCAACGGGGTGCGATAAGA -> AAACCCGCGGTATCCTTACC
AAACCCGCGGTATCCTTACC -> GTGCTATGCCGATGAGGAAT
GTGCTATGCCGATGAGGAAT -> GTGCTAGTATGACTGGCGAT
GTGCTAGTATGACTGGCGAT -> GTAGCAACGGGGTGCGATAA
GTAGCAACGGGGTGCGATAA -> AACCTATTTCTACATAGAAG
AACCTATTTCTACATAGAAG -> GAGACAGGTGCCACCGTGAC
GAGACAGGTGCCACCGTGAC -> GGCTTCCACCGGCGGGGTTC
GGCTTCCACCGGCGGGGTTC -> GGTTAAGGGAGTTGCCCCGC
GGTTAAGGGAGTTGCCCCGC -> GCGGAATCATATGGGTGCTA
GCGGAATCATATGGGTGCTA -> AGGTGGTCTTTAAAGGGGCA
AGGTGGTCTTTAAAGGGGCA -> TATTATGACAGTCAGTAAAA
TATTATGACAGTCAGTAAAA -> AGATAAGGGGATTGCACTTG
AGATAAGGGGATTGCACTTG -> CTATCTGGGGCTTCCACCGG
CTATCTGGGGCTTCCACCGG -> GATGCAGGGTATCTTAGCCC
GATGCAGGGTATCTTAGCCC -> TACATAGAAGCGCGGAATCA
TACATAGAAGCGCGGAATCA -> CTTAGCCCATAAGAGTGCGC
CTTAGCCCATAAGAGTGCGC -> GATCCTTAAAGATCATTGAG
GATCCTTAAAGATCATTGAG -> GTATCCTTACCTTGGTTAAG
GTATCCTTACCTTGGTTAAG -> AGGTGGGCATTTAACGCCTA
AGGTGGGCATTTAACGCCTA -> AGGAATCCGTATTCTTGGCG
AGGAATCCGTATTCTTGGCG -> AAACGAACGCACATGACGTA
AAACGAACGCACATGACGTA -> TAGCCATTACGCAGTTATAT
TAGCCATTACGCAGTTATAT -> CTTTCAAGGGGGCTATTAGA
CTTTCAAGGGGGCTATTAGA -> CAAGGGGGCTATTAGAGCCT
CAAGGGGGCTATTAGAGCCT -> GGGTATCTTAGCCCATAAGA
GGGTATCTTAGCCCATAAGA -> TCTCGTTCACGACCTGTTTC
TCTCGTTCACGACCTGTTTC -> CATATGGGTGCTATGCCGAT
CATATGGGTGCTATGCCGAT -> GATCGCCGAATATGGTAGAC
GATCGCCGAATATGGTAGAC -> GAACCACAGACGTAACCCTT
GAACCACAGACGTAACCCTT -> TTTTCCCAGATAAGGGGATT
TTTTCCCAGATAAGGGGATT -> ATCGACCTCTTTCAAGGGGG
ATCGACCTCTTTCAAGGGGG -> AACTGGCGGCAGCTCTTGTC
AACTGGCGGCAGCTCTTGTC -> GTTCTCGTTCACGACCTGTT
GTTCTCGTTCACGACCTGTT -> ATCCTTAAAGATCATTGAGA
ATCCTTAAAGATCATTGAGA -> CCTCGCTTGTTTCGTTGGAA
CCTCGCTTGTTTCGTTGGAA -> TACGGCGATCGACGACAACG
TACGGCGATCGACGACAACG -> CAGCACATAACAGCCAGCAA
CAGCACATAACAGCCAGCAA -> CTTTAAAGGGGCACAACTAG
CTTTAAAGGGGCACAACTAG -> GAGCTAAACCACCCGCGAAC
GAGCTAAACCACCCGCGAAC -> CTACATAGAAGCGCGGAATC
CTACATAGAAGCGCGGAATC -> CGCACTAGTAGGAGTTAGAT
CGCACTAGTAGGAGTTAGAT -> ATTCTTGGCGTGGTTGTAGG
ATTCTTGGCGTGGTTGTAGG -> CGGCGATCGACGACAACGAA
CGGCGATCGACGACAACGAA -> AACAGCCAGCAAGTAGCAAC
AACAGCCAGCAAGTAGCAAC -> GCTCAGACTGGGGAGTATTT
GCTCAGACTGGGGAGTATTT -> GCTATTAGAGCCTCAAACCC
GCTATTAGAGCCTCAAACCC -> CTATTAGAGCCTCAAACCCT
CTATTAGAGCCTCAAACCCT -> GTATTTGGGCTTTTTCCCAG
GTATTTGGGCTTTTTCCCAG -> TTTCTTTGGAAGGCTTAGCG
TTTCTTTGGAAGGCTTAGCG -> CCCATAAGAGTGCGCAATTT
CCCATAAGAGTGCGCAATTT -> CACCCGGACTCTGACTCCAT
CACCCGGACTCTGACTCCAT -> CGGCGGGGTTCTCGTTCACG
CGGCGGGGTTCTCGTTCACG -> AGAAAAATATTATGACAGTC
AGAAAAATATTATGACAGTC -> TTTGGGCTTTTTCCCAGATA
TTTGGGCTTTTTCCCAGATA -> TAGAAGCGCGGAATCATATG
TAGAAGCGCGGAATCATATG -> TATGACAGTCAGTAAAATTT
TATGACAGTCAGTAAAATTT -> GGGCACAACTAGAGACAGGT
GGGCACAACTAGAGACAGGT -> CTAGTAGGAGTTAGATGTTT
CTAGTAGGAGTTAGATGTTT -> CGTAACCCTTCTTCACCGAC
CGTAACCCTTCTTCACCGAC -> GCGATGCAGGGTATCTTAGC
GCGATGCAGGGTATCTTAGC -> TATTCTTGGCGTGGTTGTAG
TATTCTTGGCGTGGTTGTAG -> TCTTAGCCCATAAGAGTGCG
TCTTAGCCCATAAGAGTGCG -> CTCTTGTCGGCTGGTCGCAT
CTCTTGTCGGCTGGTCGCAT -> CGTTCTCACCCGGACTCTGA
CGTTCTCACCCGGACTCTGA -> CAGCCAGCAAGTAGCAACGG
CAGCCAGCAAGTAGCAACGG -> GGGGTTCTCGTTCACGACCT
GGGGTTCTCGTTCACGACCT -> TCACCCAATCCGGAATACGT
TCACCCAATCCGGAATACGT -> CGGCTGGTCGCATCTCTGGC
CGGCTGGTCGCATCTCTGGC -> CGTGTAAAAACCTATTTCTA
CGTGTAAAAACCTATTTCTA -> GGCGATCGACGACAACGAAT
GGCGATCGACGACAACGAAT -> TGCACTTGAATCCGTGTAAA
TGCACTTGAATCCGTGTAAA -> GTTACATCGACCTCTTTCAA
GTTACATCGACCTCTTTCAA -> CAATTTTCCTTACGGCGATC
CAATTTTCCTTACGGCGATC -> TGTGAGATGCGAATTTACCG
TGTGAGATGCGAATTTACCG -> TGCTAGTATGACTGGCGATG
TGCTAGTATGACTGGCGATG -> CTCAAACCCTTTCTTTGGAA
CTCAAACCCTTTCTTTGGAA -> GGGTGCGATAAGAAAAGGAT
GGGTGCGATAAGAAAAGGAT -> CCTGTGAGATGCGAATTTAC
CCTGTGAGATGCGAATTTAC -> GACTCTGACTCCATTCGGTG
GACTCTGACTCCATTCGGTG -> GAGTGCGCAATTTTCCTTAC
GAGTGCGCAATTTTCCTTAC -> GGACGAGGCGCACTAGTAGG
GGACGAGGCGCACTAGTAGG -> TGGTTGTACTGCTCAAGTGG
TGGTTGTACTGCTCAAGTGG -> AACTCAGCTACAGACTAGAA
AACTCAGCTACAGACTAGAA -> TAAGGGAGTTGCCCCGCCCC
TAAGGGAGTTGCCCCGCCCC -> ATAGAAGCGCGGAATCATAT
ATAGAAGCGCGGAATCATAT -> ACTCAGCTACAGACTAGAAA
ACTCAGCTACAGACTAGAAA -> AATATTATGACAGTCAGTAA
AATATTATGACAGTCAGTAA -> TCAAGGGGGCTATTAGAGCC
TCAAGGGGGCTATTAGAGCC -> ACAGCCAGCAAGTAGCAACG
ACAGCCAGCAAGTAGCAACG -> GTAACCCTTCTTCACCGACG
GTAACCCTTCTTCACCGACG -> GTGTAAAAACCTATTTCTAC
GTGTAAAAACCTATTTCTAC -> AAAGAGTAGGTGGTCTTTAA
AAAGAGTAGGTGGTCTTTAA -> CTTTGGAAGGCTTAGCGGCT
CTTTGGAAGGCTTAGCGGCT -> CAGACGTAACCCTTCTTCAC
CAGACGTAACCCTTCTTCAC -> AGACTGGGGAGTATTTGGGC
AGACTGGGGAGTATTTGGGC -> AGGGGGCTATTAGAGCCTCA
AGGGGGCTATTAGAGCCTCA -> TTGATATAACTGGCGGCAGC
TTGATATAACTGGCGGCAGC -> TTGTCGGCTGGTCGCATCTC
TTGTCGGCTGGTCGCATCTC -> TAAAAGAGTAGGTGGTCTTT
TAAAAGAGTAGGTGGTCTTT -> TGGAAGGCTTAGCGGCTCAG
TGGAAGGCTTAGCGGCTCAG -> GCACAACTAGAGACAGGTGC
GCACAACTAGAGACAGGTGC -> TGAGAAAGAAAAATATTATG
TGAGAAAGAAAAATATTATG -> CAGGTGCCACCGTGACAACG
CAGGTGCCACCGTGACAACG -> ACAGACTAGAAAGCTTCCCA
ACAGACTAGAAAGCTTCCCA -> CCACCCGCGAACCAATGTGC
CCACCCGCGAACCAATGTGC -> ATAAGGGGATTGCACTTGAA
ATAAGGGGATTGCACTTGAA -> TGCGATAAGAAAAGGATCCT
TGCGATAAGAAAAGGATCCT -> GCAATTTTCCTTACGGCGAT
GCAATTTTCCTTACGGCGAT -> TATTAGAGCCTCAAACCCTT
TATTAGAGCCTCAAACCCTT -> CTTCCCAGGTGGGCATTTAA
CTTCCCAGGTGGGCATTTAA -> GATCGACGACAACGAATAAA
GATCGACGACAACGAATAAA -> GAGCCTCAAACCCTTTCTTT
GAGCCTCAAACCCTTTCTTT -> GGGGTGCGATAAGAAAAGGA
GGGGTGCGATAAGAAAAGGA -> AGTAGGAGTTAGATGTTTTA
AGTAGGAGTTAGATGTTTTA -> TGGCGTGGTTGTAGGCATCA
TGGCGTGGTTGTAGGCATCA -> CTGGGGCTTCCACCGGCGGG
CTGGGGCTTCCACCGGCGGG -> AATTTACCGACTCAGCACAT
AATTTACCGACTCAGCACAT -> TAGAGCCTCAAACCCTTTCT
TAGAGCCTCAAACCCTTTCT -> GAATCCGTGTAAAAACCTAT
GAATCCGTGTAAAAACCTAT -> GCCATTACGCAGTTATATGT
GCCATTACGCAGTTATATGT -> CCTCTTTCAAGGGGGCTATT
CCTCTTTCAAGGGGGCTATT -> AGTGGACATTAGCCATTACG
AGTGGACATTAGCCATTACG -> AGAAAGCTTCCCAGGTGGGC
AGAAAGCTTCCCAGGTGGGC -> ATGACGTATCGCAGTTGATA
ATGACGTATCGCAGTTGATA -> GTAAAATTTATTCGTTCTCA
GTAAAATTTATTCGTTCTCA -> ACATGACGTATCGCAGTTGA
ACATGACGTATCGCAGTTGA -> ACCGGCGGGGTTCTCGTTCA
ACCGGCGGGGTTCTCGTTCA -> TCTCACCCGGACTCTGACTC
TCTCACCCGGACTCTGACTC -> CCCAATCCGGAATACGTCCG
CCCAATCCGGAATACGTCCG -> CACGACCTGTTTCACCCAAT
CACGACCTGTTTCACCCAAT -> CTTGTCGGCTGGTCGCATCT
CTTGTCGGCTGGTCGCATCT -> CAACGGGGTGCGATAAGAAA
CAACGGGGTGCGATAAGAAA -> TGGGTGCTATGCCGATGAGG
TGGGTGCTATGCCGATGAGG -> TGGGGCTTCCACCGGCGGGG
TGGGGCTTCCACCGGCGGGG -> ACGTAACCCTTCTTCACCGA
ACGTAACCCTTCTTCACCGA -> TTGAGAAAGAAAAATATTAT
TTGAGAAAGAAAAATATTAT -> ACTAGAGACAGGTGCCACCG
ACTAGAGACAGGTGCCACCG -> GAATATGGTAGACCCTCGCT
GAATATGGTAGACCCTCGCT -> GCCGATGAGGAATCCGTATT
GCCGATGAGGAATCCGTATT -> ATTACGCAGTTATATGTAGG
ATTACGCAGTTATATGTAGG -> TGGTACGGCAGAGCTTGGTT
TGGTACGGCAGAGCTTGGTT -> CATTACGCAGTTATATGTAG
CATTACGCAGTTATATGTAG -> CGACTCAGCACATAACAGCC
CGACTCAGCACATAACAGCC -> ATATGGTAGACCCTCGCTTG
ATATGGTAGACCCTCGCTTG -> GGAGTTAGATGTTTTAGGTT
GGAGTTAGATGTTTTAGGTT -> AGTTAGATGTTTTAGGTTAC
AGTTAGATGTTTTAGGTTAC -> GGGATTGCACTTGAATCCGT
GGGATTGCACTTGAATCCGT -> CCTTACGGCGATCGACGACA
CCTTACGGCGATCGACGACA -> CGGGGACGAGGCGCACTAGT
CGGGGACGAGGCGCACTAGT -> CGTGCTCAGACTGGGGAGTA
CGTGCTCAGACTGGGGAGTA -> TCCGGAATACGTCCGATCGC
TCCGGAATACGTCCGATCGC -> ATGACAGTCAGTAAAATTTA
ATGACAGTCAGTAAAATTTA -> AGGTGAGCTAAACCACCCGC
AGGTGAGCTAAACCACCCGC -> GGTCGCATCTCTGGCAATGG
GGTCGCATCTCTGGCAATGG -> CAGACTAGAAAGCTTCCCAG
CAGACTAGAAAGCTTCCCAG -> GCCGCTAGATGGCTCGAGGT
GCCGCTAGATGGCTCGAGGT -> TAGATGTTTTAGGTTACATC
TAGATGTTTTAGGTTACATC -> CTCACCCGGACTCTGACTCC
CTCACCCGGACTCTGACTCC -> CTTCTTCACCGACGCGGGGA
CTTCTTCACCGACGCGGGGA -> AGCGGCTCAGAACTCAGCTA
AGCGGCTCAGAACTCAGCTA -> ACCTTGGTTAAGGGAGTTGC
ACCTTGGTTAAGGGAGTTGC -> CGCGGTATCCTTACCTTGGT
CGCGGTATCCTTACCTTGGT -> CTTGAATCCGTGTAAAAACC
CTTGAATCCGTGTAAAAACC -> GTAAAAACCTATTTCTACAT
GTAAAAACCTATTTCTACAT -> TGACAGTCAGTAAAATTTAT
TGACAGTCAGTAAAATTTAT -> TTATATGTAGGGTAAATTCA
TTATATGTAGGGTAAATTCA -> CTGCTCAAGTGGACATTAGC
CTGCTCAAGTGGACATTAGC -> TGTTTCACCCAATCCGGAAT
TGTTTCACCCAATCCGGAAT -> GCAGGGTATCTTAGCCCATA
GCAGGGTATCTTAGCCCATA -> AATGGAACCACAGACGTAAC
AATGGAACCACAGACGTAAC -> TTGGAACTGAATACCTGTGA
TTGGAACTGAATACCTGTGA -> CTCGTTCACGACCTGTTTCA
CTCGTTCACGACCTGTTTCA -> GGGGCACAACTAGAGACAGG
GGGGCACAACTAGAGACAGG -> GTGCTCAGACTGGGGAGTAT
GTGCTCAGACTGGGGAGTAT -> CACAACTAGAGACAGGTGCC
CACAACTAGAGACAGGTGCC -> ATCATTGAGAAAGAAAAATA
ATCATTGAGAAAGAAAAATA -> GACTGGCGATGCAGGGTATC
GACTGGCGATGCAGGGTATC -> ATCTTAGCCCATAAGAGTGC
ATCTTAGCCCATAAGAGTGC -> GCTTGTTTCGTTGGAACTGA
GCTTGTTTCGTTGGAACTGA -> AAAGATCATTGAGAAAGAAA
AAAGATCATTGAGAAAGAAA -> AAGTGGACATTAGCCATTAC
AAGTGGACATTAGCCATTAC -> GTGGTTGTAGGCATCAAACG
GTGGTTGTAGGCATCAAACG -> CTGGCGGCAGCTCTTGTCGG
CTGGCGGCAGCTCTTGTCGG -> ATTTATTCGTTCTCACCCGG
ATTTATTCGTTCTCACCCGG -> GTTATATGTAGGGTAAATTC
GTTATATGTAGGGTAAATTC -> CACTAGTAGGAGTTAGATGT
CACTAGTAGGAGTTAGATGT -> GAGGCGCACTAGTAGGAGTT
GAGGCGCACTAGTAGGAGTT -> TTACCTTGGTTAAGGGAGTT
TTACCTTGGTTAAGGGAGTT -> GGAGTATTTGGGCTTTTTCC
GGAGTATTTGGGCTTTTTCC -> ACCACAGACGTAACCCTTCT
ACCACAGACGTAACCCTTCT -> TCGCATCTCTGGCAATGGAA
TCGCATCTCTGGCAATGGAA -> TTTCGTTGGAACTGAATACC
TTTCGTTGGAACTGAATACC -> AATCCGTATTCTTGGCGTGG
AATCCGTATTCTTGGCGTGG -> ATTCGGTGGTACGGCAGAGC
ATTCGGTGGTACGGCAGAGC -> CCCAGATAAGGGGATTGCAC
CCCAGATAAGGGGATTGCAC -> CGGACTCTGACTCCATTCGG
CGGACTCTGACTCCATTCGG -> CATAGAAGCGCGGAATCATA
CATAGAAGCGCGGAATCATA -> TCGCAGTTGATATAACTGGC
TCGCAGTTGATATAACTGGC -> GTGACAACGTGCTCAGACTG
GTGACAACGTGCTCAGACTG -> AAGCGCGGAATCATATGGGT
AAGCGCGGAATCATATGGGT -> CAGATAAGGGGATTGCACTT
CAGATAAGGGGATTGCACTT -> ATGACTGGCGATGCAGGGTA
ATGACTGGCGATGCAGGGTA -> CTTGGTTGTACTGCTCAAGT
CTTGGTTGTACTGCTCAAGT -> CACTTGAATCCGTGTAAAAA
CACTTGAATCCGTGTAAAAA -> TGAGGAATCCGTATTCTTGG
TGAGGAATCCGTATTCTTGG -> CCAATCCGGAATACGTCCGA
CCAATCCGGAATACGTCCGA -> CGAATAAAAGAGTAGGTGGT
CGAATAAAAGAGTAGGTGGT -> GGGCTATTAGAGCCTCAAAC
GGGCTATTAGAGCCTCAAAC -> GCGAACCAATGTGCTAGTAT
GCGAACCAATGTGCTAGTAT -> CCATTACGCAGTTATATGTA
CCATTACGCAGTTATATGTA -> TCTCTGGCAATGGAACCACA
TCTCTGGCAATGGAACCACA -> TTAGATGTTTTAGGTTACAT
TTAGATGTTTTAGGTTACAT -> CGGCAGAGCTTGGTTGTACT
CGGCAGAGCTTGGTTGTACT -> TATCCTTACCTTGGTTAAGG
TATCCTTACCTTGGTTAAGG -> ACGTGCTCAGACTGGGGAGT
ACGTGCTCAGACTGGGGAGT -> GACCTGTTTCACCCAATCCG
GACCTGTTTCACCCAATCCG -> AAATTCAAACCCGCGGTATC
AAATTCAAACCCGCGGTATC -> CGCCGAATATGGTAGACCCT
CGCCGAATATGGTAGACCCT -> GGCGATGCAGGGTATCTTAG
GGCGATGCAGGGTATCTTAG -> CACCCGCGAACCAATGTGCT
CACCCGCGAACCAATGTGCT -> CAACGAATAAAAGAGTAGGT
CAACGAATAAAAGAGTAGGT -> CCGACTCAGCACATAACAGC
CCGACTCAGCACATAACAGC -> GTCCGATCGCCGAATATGGT
GTCCGATCGCCGAATATGGT -> AGAGTGCGCAATTTTCCTTA
AGAGTGCGCAATTTTCCTTA -> GGCTATTAGAGCCTCAAACC
GGCTATTAGAGCCTCAAACC -> TACGCAGTTATATGTAGGGT
TACGCAGTTATATGTAGGGT -> TGCGAATTTACCGACTCAGC
TGCGAATTTACCGACTCAGC -> CGGTGGTACGGCAGAGCTTG
CGGTGGTACGGCAGAGCTTG -> TGCAGGGTATCTTAGCCCAT
TGCAGGGTATCTTAGCCCAT -> AGATGGCTCGAGGTGAGCTA
AGATGGCTCGAGGTGAGCTA -> TCGTTCACGACCTGTTTCAC
TCGTTCACGACCTGTTTCAC -> CGTTCACGACCTGTTTCACC
CGTTCACGACCTGTTTCACC -> AGTAGGTGGTCTTTAAAGGG
AGTAGGTGGTCTTTAAAGGG -> ATCCGTATTCTTGGCGTGGT
ATCCGTATTCTTGGCGTGGT -> CACCGTGACAACGTGCTCAG
CACCGTGACAACGTGCTCAG -> TTAGCCCATAAGAGTGCGCA
TTAGCCCATAAGAGTGCGCA -> GTGCGCAATTTTCCTTACGG
GTGCGCAATTTTCCTTACGG -> CTACAGACTAGAAAGCTTCC
CTACAGACTAGAAAGCTTCC -> ACCGACTCAGCACATAACAG
ACCGACTCAGCACATAACAG -> TAAAATTTATTCGTTCTCAC
TAAAATTTATTCGTTCTCAC -> GCTTAGCGGCTCAGAACTCA
GCTTAGCGGCTCAGAACTCA -> AGATGCGAATTTACCGACTC
AGATGCGAATTTACCGACTC -> AAACCTATTTCTACATAGAA
AAACCTATTTCTACATAGAA -> CCATAAGAGTGCGCAATTTT
CCATAAGAGTGCGCAATTTT -> GCGGTATCCTTACCTTGGTT
GCGGTATCCTTACCTTGGTT -> GGGCATTTAACGCCTATCTG
GGGCATTTAACGCCTATCTG -> CAGTAAAATTTATTCGTTCT
CAGTAAAATTTATTCGTTCT -> CTTCACCGACGCGGGGACGA
CTTCACCGACGCGGGGACGA -> AGGGAGTTGCCCCGCCCCAG
AGGGAGTTGCCCCGCCCCAG -> TCCTTACCTTGGTTAAGGGA
TCCTTACCTTGGTTAAGGGA -> CAAACCCTTTCTTTGGAAGG
CAAACCCTTTCTTTGGAAGG -> GGTGCTATGCCGATGAGGAA
GGTGCTATGCCGATGAGGAA -> TGCTCAGACTGGGGAGTATT
TGCTCAGACTGGGGAGTATT -> ACGACCTGTTTCACCCAATC
ACGACCTGTTTCACCCAATC -> AAGGGGCACAACTAGAGACA
AAGGGGCACAACTAGAGACA -> TCAAACCCGCGGTATCCTTA
TCAAACCCGCGGTATCCTTA -> ATAAGAAAAGGATCCTTAAA
ATAAGAAAAGGATCCTTAAA -> GTGGGCATTTAACGCCTATC
GTGGGCATTTAACGCCTATC -> CGGCAGCTCTTGTCGGCTGG
CGGCAGCTCTTGTCGGCTGG -> CCAGCAAGTAGCAACGGGGT
CCAGCAAGTAGCAACGGGGT -> CGACGCGGGGACGAGGCGCA
CGACGCGGGGACGAGGCGCA -> TCTGACTCCATTCGGTGGTA
TCTGACTCCATTCGGTGGTA -> AACCAATGTGCTAGTATGAC
AACCAATGTGCTAGTATGAC -> TATGCCGATGAGGAATCCGT
TATGCCGATGAGGAATCCGT -> CTTTCTTTGGAAGGCTTAGC
CTTTCTTTGGAAGGCTTAGC -> ACTGGGGAGTATTTGGGCTT
ACTGGGGAGTATTTGGGCTT -> GGCTCAGAACTCAGCTACAG
GGCTCAGAACTCAGCTACAG -> ATGTAGGGTAAATTCAAACC
ATGTAGGGTAAATTCAAACC -> CCTATCTGGGGCTTCCACCG
CCTATCTGGGGCTTCCACCG -> TTGCAGCGACTGTGCCGCTA
TTGCAGCGACTGTGCCGCTA -> ACTGGCGGCAGCTCTTGTCG
ACTGGCGGCAGCTCTTGTCG -> TTCACCGACGCGGGGACGAG
TTCACCGACGCGGGGACGAG -> GTTGTAGGCATCAAACGAAC
GTTGTAGGCATCAAACGAAC -> CTAGATGGCTCGAGGTGAGC
CTAGATGGCTCGAGGTGAGC -> CGATCGACGACAACGAATAA
CGATCGACGACAACGAATAA -> CCTCAAACCCTTTCTTTGGA
CCTCAAACCCTTTCTTTGGA -> CGAATTTACCGACTCAGCAC
CGAATTTACCGACTCAGCAC -> ATCTGGGGCTTCCACCGGCG
ATCTGGGGCTTCCACCGGCG -> GACTAGAAAGCTTCCCAGGT
GACTAGAAAGCTTCCCAGGT -> GCTAGTATGACTGGCGATGC
GCTAGTATGACTGGCGATGC -> TGGCGGCAGCTCTTGTCGGC
TGGCGGCAGCTCTTGTCGGC -> AGGGGATTGCACTTGAATCC
AGGGGATTGCACTTGAATCC -> AAGGGAGTTGCCCCGCCCCA
AAGGGAGTTGCCCCGCCCCA -> TGTCGGCTGGTCGCATCTCT
TGTCGGCTGGTCGCATCTCT -> GTTTCGTTGGAACTGAATAC
GTTTCGTTGGAACTGAATAC -> CACAGACGTAACCCTTCTTC
CACAGACGTAACCCTTCTTC -> GCAAGTAGCAACGGGGTGCG
GCAAGTAGCAACGGGGTGCG -> ACATAACAGCCAGCAAGTAG
ACATAACAGCCAGCAAGTAG -> AAAGAAAAATATTATGACAG
AAAGAAAAATATTATGACAG -> TGGGCTTTTTCCCAGATAAG
TGGGCTTTTTCCCAGATAAG -> CAACTAGAGACAGGTGCCAC
CAACTAGAGACAGGTGCCAC -> TATCTGGGGCTTCCACCGGC
TATCTGGGGCTTCCACCGGC -> CTGGGGAGTATTTGGGCTTT
CTGGGGAGTATTTGGGCTTT -> GATGTTTTAGGTTACATCGA
GATGTTTTAGGTTACATCGA -> ATGCGAATTTACCGACTCAG
ATGCGAATTTACCGACTCAG -> CTAAACCACCCGCGAACCAA
CTAAACCACCCGCGAACCAA -> GGGCTTCCACCGGCGGGGTT
GGGCTTCCACCGGCGGGGTT -> CCGCGGTATCCTTACCTTGG
CCGCGGTATCCTTACCTTGG -> AACGTGCTCAGACTGGGGAG
AACGTGCTCAGACTGGGGAG -> GGCGGGGTTCTCGTTCACGA
GGCGGGGTTCTCGTTCACGA -> TGAATACCTGTGAGATGCGA
TGAATACCTGTGAGATGCGA -> TAGGTTACATCGACCTCTTT
TAGGTTACATCGACCTCTTT -> GTGAGCTAAACCACCCGCGA
GTGAGCTAAACCACCCGCGA -> GTACTGCTCAAGTGGACATT
GTACTGCTCAAGTGGACATT -> GCAGTTGATATAACTGGCGG
GCAGTTGATATAACTGGCGG -> TATTTGGGCTTTTTCCCAGA
TATTTGGGCTTTTTCCCAGA -> ATCGCAGTTGATATAACTGG
ATCGCAGTTGATATAACTGG -> TGTTTTAGGTTACATCGACC
TGTTTTAGGTTACATCGACC -> TACCTGTGAGATGCGAATTT
TACCTGTGAGATGCGAATTT -> AGCGCGGAATCATATGGGTG
AGCGCGGAATCATATGGGTG -> ATGGTAGACCCTCGCTTGTT
ATGGTAGACCCTCGCTTGTT -> ACGACAACGAATAAAAGAGT
ACGACAACGAATAAAAGAGT -> CCACCGGCGGGGTTCTCGTT
CCACCGGCGGGGTTCTCGTT -> TCACCGACGCGGGGACGAGG
TCACCGACGCGGGGACGAGG -> AGTCAGTAAAATTTATTCGT
AGTCAGTAAAATTTATTCGT -> CCCTCGCTTGTTTCGTTGGA
CCCTCGCTTGTTTCGTTGGA -> TCGACCTCTTTCAAGGGGGC
TCGACCTCTTTCAAGGGGGC -> TAGCCCATAAGAGTGCGCAA
TAGCCCATAAGAGTGCGCAA -> GTGGACATTAGCCATTACGC
GTGGACATTAGCCATTACGC -> TTCTTCACCGACGCGGGGAC
TTCTTCACCGACGCGGGGAC -> CTCGAGGTGAGCTAAACCAC
CTCGAGGTGAGCTAAACCAC -> ACTTGAATCCGTGTAAAAAC
ACTTGAATCCGTGTAAAAAC -> TGTAGGGTAAATTCAAACCC
TGTAGGGTAAATTCAAACCC -> GGTTGTACTGCTCAAGTGGA
GGTTGTACTGCTCAAGTGGA -> ACTCAGCACATAACAGCCAG
ACTCAGCACATAACAGCCAG -> GTAGACCCTCGCTTGTTTCG
GTAGACCCTCGCTTGTTTCG -> GCGCACTAGTAGGAGTTAGA
GCGCACTAGTAGGAGTTAGA -> AGCTAAACCACCCGCGAACC
AGCTAAACCACCCGCGAACC -> TCCCAGATAAGGGGATTGCA
TCCCAGATAAGGGGATTGCA -> GCGTGGTTGTAGGCATCAAA
GCGTGGTTGTAGGCATCAAA -> TAACAGCCAGCAAGTAGCAA
TAACAGCCAGCAAGTAGCAA -> GCTTTTTCCCAGATAAGGGG
GCTTTTTCCCAGATAAGGGG -> CGAGGTGAGCTAAACCACCC
CGAGGTGAGCTAAACCACCC -> ATGCAGGGTATCTTAGCCCA
ATGCAGGGTATCTTAGCCCA -> ATTTTCCTTACGGCGATCGA
ATTTTCCTTACGGCGATCGA -> AATAAAAGAGTAGGTGGTCT
AATAAAAGAGTAGGTGGTCT -> CCCGCGGTATCCTTACCTTG
CCCGCGGTATCCTTACCTTG -> TTTCTACATAGAAGCGCGGA
TTTCTACATAGAAGCGCGGA -> AAGAGTGCGCAATTTTCCTT
AAGAGTGCGCAATTTTCCTT -> GGCATCAAACGAACGCACAT
GGCATCAAACGAACGCACAT -> GAGATGCGAATTTACCGACT
GAGATGCGAATTTACCGACT -> TTCGTTCTCACCCGGACTCT
TTCGTTCTCACCCGGACTCT -> GTCGGCTGGTCGCATCTCTG
GTCGGCTGGTCGCATCTCTG -> TCTTGTCGGCTGGTCGCATC
TCTTGTCGGCTGGTCGCATC -> CCTTGGTTAAGGGAGTTGCC
CCTTGGTTAAGGGAGTTGCC -> CATCAAACGAACGCACATGA
CATCAAACGAACGCACATGA -> CGCTAGATGGCTCGAGGTGA
CGCTAGATGGCTCGAGGTGA -> TGGGGAGTATTTGGGCTTTT
TGGGGAGTATTTGGGCTTTT -> TTTGGAAGGCTTAGCGGCTC
TTTGGAAGGCTTAGCGGCTC -> TTCAAACCCGCGGTATCCTT
TTCAAACCCGCGGTATCCTT -> TAAAGATCATTGAGAAAGAA
TAAAGATCATTGAGAAAGAA -> GGTAGACCCTCGCTTGTTTC
GGTAGACCCTCGCTTGTTTC -> ATCTCTGGCAATGGAACCAC
ATCTCTGGCAATGGAACCAC -> ATATTATGACAGTCAGTAAA
ATATTATGACAGTCAGTAAA -> GAGTAGGTGGTCTTTAAAGG
GAGTAGGTGGTCTTTAAAGG -> CGACCTCTTTCAAGGGGGCT
CGACCTCTTTCAAGGGGGCT -> TGATATAACTGGCGGCAGCT
TGATATAACTGGCGGCAGCT -> CACATGACGTATCGCAGTTG
CACATGACGTATCGCAGTTG -> TTTCCCAGATAAGGGGATTG
TTTCCCAGATAAGGGGATTG -> GCCTTGCAGCGACTGTGCCG
GCCTTGCAGCGACTGTGCCG -> TTAAGGGAGTTGCCCCGCCC
TTAAGGGAGTTGCCCCGCCC -> CATAACAGCCAGCAAGTAGC
CATAACAGCCAGCAAGTAGC -> AACGAACGCACATGACGTAT
AACGAACGCACATGACGTAT -> GAACGCACATGACGTATCGC
GAACGCACATGACGTATCGC -> TTACGGCGATCGACGACAAC
TTACGGCGATCGACGACAAC -> GATTGCACTTGAATCCGTGT
GATTGCACTTGAATCCGTGT -> TTGGCGTGGTTGTAGGCATC
TTGGCGTGGTTGTAGGCATC -> TTATGACAGTCAGTAAAATT
TTATGACAGTCAGTAAAATT -> TAAGAGTGCGCAATTTTCCT
TAAGAGTGCGCAATTTTCCT -> TATGACTGGCGATGCAGGGT
TATGACTGGCGATGCAGGGT -> ACCCTTCTTCACCGACGCGG
ACCCTTCTTCACCGACGCGG -> TATATGTAGGGTAAATTCAA
TATATGTAGGGTAAATTCAA -> GTTGTACTGCTCAAGTGGAC
GTTGTACTGCTCAAGTGGAC -> GATGGCTCGAGGTGAGCTAA
GATGGCTCGAGGTGAGCTAA -> TCAAACCCTTTCTTTGGAAG
TCAAACCCTTTCTTTGGAAG -> ACGTATCGCAGTTGATATAA
ACGTATCGCAGTTGATATAA -> AGCTACAGACTAGAAAGCTT
AGCTACAGACTAGAAAGCTT -> ACTGTGCCGCTAGATGGCTC
ACTGTGCCGCTAGATGGCTC -> GAATAAAAGAGTAGGTGGTC
GAATAAAAGAGTAGGTGGTC -> AATATGGTAGACCCTCGCTT
AATATGGTAGACCCTCGCTT -> TGGCTCGAGGTGAGCTAAAC
TGGCTCGAGGTGAGCTAAAC -> GACTGTGCCGCTAGATGGCT
GACTGTGCCGCTAGATGGCT -> CTCCATTCGGTGGTACGGCA
CTCCATTCGGTGGTACGGCA -> TTACATCGACCTCTTTCAAG
TTACATCGACCTCTTTCAAG -> ACTCTGACTCCATTCGGTGG
ACTCTGACTCCATTCGGTGG -> AGAGCCTTGCAGCGACTGTG
AGAGCCTTGCAGCGACTGTG -> GGTTGTAGGCATCAAACGAA
GGTTGTAGGCATCAAACGAA -> TACATCGACCTCTTTCAAGG
TACATCGACCTCTTTCAAGG -> ACTGCTCAAGTGGACATTAG
ACTGCTCAAGTGGACATTAG -> ACAGTCAGTAAAATTTATTC
ACAGTCAGTAAAATTTATTC -> CGATGCAGGGTATCTTAGCC
CGATGCAGGGTATCTTAGCC -> TGGTTAAGGGAGTTGCCCCG
TGGTTAAGGGAGTTGCCCCG -> AGCCTCAAACCCTTTCTTTG
AGCCTCAAACCCTTTCTTTG -> TCCACCGGCGGGGTTCTCGT
TCCACCGGCGGGGTTCTCGT -> AGCTTGGTTGTACTGCTCAA
AGCTTGGTTGTACTGCTCAA -> ACGCCTATCTGGGGCTTCCA
ACGCCTATCTGGGGCTTCCA -> TTACGCAGTTATATGTAGGG
TTACGCAGTTATATGTAGGG -> TTTTTCCCAGATAAGGGGAT
TTTTTCCCAGATAAGGGGAT -> TCATTGAGAAAGAAAAATAT
TCATTGAGAAAGAAAAATAT -> GACAGGTGCCACCGTGACAA
GACAGGTGCCACCGTGACAA -> GTTAAGGGAGTTGCCCCGCC
GTTAAGGGAGTTGCCCCGCC -> GGCACAACTAGAGACAGGTG
GGCACAACTAGAGACAGGTG -> TATCGCAGTTGATATAACTG
TATCGCAGTTGATATAACTG -> CGGTATCCTTACCTTGGTTA
CGGTATCCTTACCTTGGTTA -> TTAGAGCCTCAAACCCTTTC
TTAGAGCCTCAAACCCTTTC -> GACGTAACCCTTCTTCACCG
GACGTAACCCTTCTTCACCG -> GGCTTAGCGGCTCAGAACTC
GGCTTAGCGGCTCAGAACTC -> TCGCTTGTTTCGTTGGAACT
TCGCTTGTTTCGTTGGAACT -> TATTTCTACATAGAAGCGCG
TATTTCTACATAGAAGCGCG -> GGTGGGCATTTAACGCCTAT
GGTGGGCATTTAACGCCTAT -> TGTTTCGTTGGAACTGAATA
TGTTTCGTTGGAACTGAATA -> CAAACGAACGCACATGACGT
CAAACGAACGCACATGACGT -> GAGTATTTGGGCTTTTTCCC
GAGTATTTGGGCTTTTTCCC -> CTTGTTTCGTTGGAACTGAA
CTTGTTTCGTTGGAACTGAA -> CTGGCGATGCAGGGTATCTT
CTGGCGATGCAGGGTATCTT -> GGGGCTTCCACCGGCGGGGT
GGGGCTTCCACCGGCGGGGT -> AAGGATCCTTAAAGATCATT
AAGGATCCTTAAAGATCATT -> TTGGTTAAGGGAGTTGCCCC
TTGGTTAAGGGAGTTGCCCC -> GTCGCATCTCTGGCAATGGA
GTCGCATCTCTGGCAATGGA -> AGGCTTAGCGGCTCAGAACT
AGGCTTAGCGGCTCAGAACT -> AATGTGCTAGTATGACTGGC
AATGTGCTAGTATGACTGGC -> TGTGCTAGTATGACTGGCGA
TGTGCTAGTATGACTGGCGA -> TCAGAACTCAGCTACAGACT
TCAGAACTCAGCTACAGACT -> AGCTTCCCAGGTGGGCATTT
AGCTTCCCAGGTGGGCATTT -> AACGGGGTGCGATAAGAAAA
AACGGGGTGCGATAAGAAAA -> AGTATGACTGGCGATGCAGG
AGTATGACTGGCGATGCAGG -> GGGCTTTTTCCCAGATAAGG
GGGCTTTTTCCCAGATAAGG -> CAGAGCCTTGCAGCGACTGT
CAGAGCCTTGCAGCGACTGT -> CTCAGACTGGGGAGTATTTG
CTCAGACTGGGGAGTATTTG -> GAGTTAGATGTTTTAGGTTA
GAGTTAGATGTTTTAGGTTA -> AGTTGATATAACTGGCGGCA
AGTTGATATAACTGGCGGCA -> ATGTGCTAGTATGACTGGCG
ATGTGCTAGTATGACTGGCG -> CTAGTATGACTGGCGATGCA
CTAGTATGACTGGCGATGCA -> GGGGATTGCACTTGAATCCG
GGGGATTGCACTTGAATCCG -> CGAACCAATGTGCTAGTATG
CGAACCAATGTGCTAGTATG -> TATGTAGGGTAAATTCAAAC
TATGTAGGGTAAATTCAAAC -> GCAGTTATATGTAGGGTAAA
GCAGTTATATGTAGGGTAAA -> TTTCACCCAATCCGGAATAC
TTTCACCCAATCCGGAATAC -> TGACGTATCGCAGTTGATAT
TGACGTATCGCAGTTGATAT -> TGGTTGTAGGCATCAAACGA
TGGTTGTAGGCATCAAACGA -> CCGGAATACGTCCGATCGCC
CCGGAATACGTCCGATCGCC -> GTTTCACCCAATCCGGAATA
GTTTCACCCAATCCGGAATA -> GGCAGAGCTTGGTTGTACTG
GGCAGAGCTTGGTTGTACTG -> CACCGACGCGGGGACGAGGC
CACCGACGCGGGGACGAGGC -> TAAACCACCCGCGAACCAAT
TAAACCACCCGCGAACCAAT -> GTGCGATAAGAAAAGGATCC
GTGCGATAAGAAAAGGATCC -> ATAAAAGAGTAGGTGGTCTT
ATAAAAGAGTAGGTGGTCTT -> GTATTCTTGGCGTGGTTGTA
GTATTCTTGGCGTGGTTGTA -> GAACTGAATACCTGTGAGAT
GAACTGAATACCTGTGAGAT -> TTCGTTGGAACTGAATACCT
TTCGTTGGAACTGAATACCT -> GCGATAAGAAAAGGATCCTT
GCGATAAGAAAAGGATCCTT -> AATTTTCCTTACGGCGATCG
AATTTTCCTTACGGCGATCG -> CGTGACAACGTGCTCAGACT
CGTGACAACGTGCTCAGACT -> ACGAACGCACATGACGTATC
ACGAACGCACATGACGTATC -> AGAAGCGCGGAATCATATGG
AGAAGCGCGGAATCATATGG -> CATTCGGTGGTACGGCAGAG
CATTCGGTGGTACGGCAGAG -> ATCCTTACCTTGGTTAAGGG
ATCCTTACCTTGGTTAAGGG -> CAGTCAGTAAAATTTATTCG
CAGTCAGTAAAATTTATTCG -> GATGCGAATTTACCGACTCA
GATGCGAATTTACCGACTCA -> AAAATTTATTCGTTCTCACC
AAAATTTATTCGTTCTCACC -> CCTATTTCTACATAGAAGCG
CCTATTTCTACATAGAAGCG -> CAGTTATATGTAGGGTAAAT
CAGTTATATGTAGGGTAAAT -> TTTAAAGGGGCACAACTAGA
TTTAAAGGGGCACAACTAGA -> AAACCCTTTCTTTGGAAGGC
AAACCCTTTCTTTGGAAGGC -> GGGTTCTCGTTCACGACCTG
GGGTTCTCGTTCACGACCTG -> GGGAGTATTTGGGCTTTTTC
GGGAGTATTTGGGCTTTTTC -> GATATAACTGGCGGCAGCTC
GATATAACTGGCGGCAGCTC -> GGGGAGTATTTGGGCTTTTT
GGGGAGTATTTGGGCTTTTT -> TAGGGTAAATTCAAACCCGC
TAGGGTAAATTCAAACCCGC -> ATTTGGGCTTTTTCCCAGAT
ATTTGGGCTTTTTCCCAGAT -> GACGAGGCGCACTAGTAGGA
GACGAGGCGCACTAGTAGGA -> GGAAGGCTTAGCGGCTCAGA
GGAAGGCTTAGCGGCTCAGA -> GAATTTACCGACTCAGCACA
GAATTTACCGACTCAGCACA -> CCGGCGGGGTTCTCGTTCAC
CCGGCGGGGTTCTCGTTCAC -> CCAGGTGGGCATTTAACGCC
CCAGGTGGGCATTTAACGCC -> GTAAATTCAAACCCGCGGTA
GTAAATTCAAACCCGCGGTA -> TATGGTAGACCCTCGCTTGT
TATGGTAGACCCTCGCTTGT -> AAACCACCCGCGAACCAATG
AAACCACCCGCGAACCAATG -> GTTAGATGTTTTAGGTTACA
GTTAGATGTTTTAGGTTACA -> GGTGGTACGGCAGAGCTTGG
GGTGGTACGGCAGAGCTTGG -> CAGCGACTGTGCCGCTAGAT
CAGCGACTGTGCCGCTAGAT -> TGACTCCATTCGGTGGTACG
TGACTCCATTCGGTGGTACG -> AGGTTACATCGACCTCTTTC
AGGTTACATCGACCTCTTTC -> ATACGTCCGATCGCCGAATA
ATACGTCCGATCGCCGAATA -> AGACGTAACCCTTCTTCACC
AGACGTAACCCTTCTTCACC -> ACGGCGATCGACGACAACGA
ACGGCGATCGACGACAACGA -> TTCAAGGGGGCTATTAGAGC
TTCAAGGGGGCTATTAGAGC -> CGCATCTCTGGCAATGGAAC
CGCATCTCTGGCAATGGAAC -> TAACCCTTCTTCACCGACGC
TAACCCTTCTTCACCGACGC -> CAGTTGATATAACTGGCGGC
CAGTTGATATAACTGGCGGC -> AGCTCTTGTCGGCTGGTCGC
AGCTCTTGTCGGCTGGTCGC -> GGCTGGTCGCATCTCTGGCA
GGCTGGTCGCATCTCTGGCA -> GATGAGGAATCCGTATTCTT
GATGAGGAATCCGTATTCTT -> CCGCTAGATGGCTCGAGGTG
CCGCTAGATGGCTCGAGGTG -> TCAGCACATAACAGCCAGCA
TCAGCACATAACAGCCAGCA -> GCAATGGAACCACAGACGTA
GCAATGGAACCACAGACGTA -> ACGAGGCGCACTAGTAGGAG
ACGAGGCGCACTAGTAGGAG -> CAAGTAGCAACGGGGTGCGA
CAAGTAGCAACGGGGTGCGA -> GCTCAGAACTCAGCTACAGA
GCTCAGAACTCAGCTACAGA -> GCTCTTGTCGGCTGGTCGCA
GCTCTTGTCGGCTGGTCGCA -> CGATGAGGAATCCGTATTCT
CGATGAGGAATCCGTATTCT -> AACCCTTCTTCACCGACGCG
AACCCTTCTTCACCGACGCG -> TTTAACGCCTATCTGGGGCT
TTTAACGCCTATCTGGGGCT -> CATCTCTGGCAATGGAACCA
CATCTCTGGCAATGGAACCA -> TACGTCCGATCGCCGAATAT
TACGTCCGATCGCCGAATAT -> TTCACCCAATCCGGAATACG
TTCACCCAATCCGGAATACG -> ATCGCCGAATATGGTAGACC
ATCGCCGAATATGGTAGACC -> GGGGGCTATTAGAGCCTCAA
GGGGGCTATTAGAGCCTCAA -> TCGACGACAACGAATAAAAG
TCGACGACAACGAATAAAAG -> CATAAGAGTGCGCAATTTTC
CATAAGAGTGCGCAATTTTC -> TGTACTGCTCAAGTGGACAT
TGTACTGCTCAAGTGGACAT -> TTACCGACTCAGCACATAAC
TTACCGACTCAGCACATAAC -> ACGGGGTGCGATAAGAAAAG
ACGGGGTGCGATAAGAAAAG -> GCGGCTCAGAACTCAGCTAC
GCGGCTCAGAACTCAGCTAC -> ATATGTAGGGTAAATTCAAA
ATATGTAGGGTAAATTCAAA -> GGCGCACTAGTAGGAGTTAG
GGCGCACTAGTAGGAGTTAG -> CCCTTTCTTTGGAAGGCTTA
CCCTTTCTTTGGAAGGCTTA -> ACCCAATCCGGAATACGTCC
ACCCAATCCGGAATACGTCC -> GGTGAGCTAAACCACCCGCG
GGTGAGCTAAACCACCCGCG -> ATGGCTCGAGGTGAGCTAAA
ATGGCTCGAGGTGAGCTAAA -> GCGAATTTACCGACTCAGCA
GCGAATTTACCGACTCAGCA -> TCAAACGAACGCACATGACG
TCAAACGAACGCACATGACG -> GGTCTTTAAAGGGGCACAAC
GGTCTTTAAAGGGGCACAAC -> ACGCGGGGACGAGGCGCACT
ACGCGGGGACGAGGCGCACT -> TTAAAGATCATTGAGAAAGA
TTAAAGATCATTGAGAAAGA -> TTCTCACCCGGACTCTGACT
TTCTCACCCGGACTCTGACT -> AACCCTTTCTTTGGAAGGCT
AACCCTTTCTTTGGAAGGCT -> AACGCACATGACGTATCGCA
AACGCACATGACGTATCGCA -> AGGTGCCACCGTGACAACGT
AGGTGCCACCGTGACAACGT -> ATGAGGAATCCGTATTCTTG
ATGAGGAATCCGTATTCTTG -> CTATGCCGATGAGGAATCCG
CTATGCCGATGAGGAATCCG -> AATCATATGGGTGCTATGCC
AATCATATGGGTGCTATGCC -> ACGCAGTTATATGTAGGGTA
ACGCAGTTATATGTAGGGTA -> TGAGCTAAACCACCCGCGAA
TGAGCTAAACCACCCGCGAA -> GCGCAATTTTCCTTACGGCG
GCGCAATTTTCCTTACGGCG -> ATTTACCGACTCAGCACATA
ATTTACCGACTCAGCACATA -> ATTTAACGCCTATCTGGGGC
ATTTAACGCCTATCTGGGGC -> AGGGTATCTTAGCCCATAAG
AGGGTATCTTAGCCCATAAG -> AAAAGAGTAGGTGGTCTTTA
AAAAGAGTAGGTGGTCTTTA -> GTGGTCTTTAAAGGGGCACA
GTGGTCTTTAAAGGGGCACA -> GGCATTTAACGCCTATCTGG
GGCATTTAACGCCTATCTGG -> ACAACGTGCTCAGACTGGGG
ACAACGTGCTCAGACTGGGG -> CGAACGCACATGACGTATCG
CGAACGCACATGACGTATCG -> GACGTATCGCAGTTGATATA
GACGTATCGCAGTTGATATA -> AGATCATTGAGAAAGAAAAA
AGATCATTGAGAAAGAAAAA -> TAGGCATCAAACGAACGCAC
TAGGCATCAAACGAACGCAC -> AAGAGTAGGTGGTCTTTAAA
AAGAGTAGGTGGTCTTTAAA -> TAACGCCTATCTGGGGCTTC
TAACGCCTATCTGGGGCTTC -> TTCCCAGGTGGGCATTTAAC
TTCCCAGGTGGGCATTTAAC -> GCTTCCACCGGCGGGGTTCT
GCTTCCACCGGCGGGGTTCT -> AAAACCTATTTCTACATAGA
AAAACCTATTTCTACATAGA -> CGACTGTGCCGCTAGATGGC
CGACTGTGCCGCTAGATGGC -> GGATCCTTAAAGATCATTGA
GGATCCTTAAAGATCATTGA -> GCGGGGTTCTCGTTCACGAC
GCGGGGTTCTCGTTCACGAC -> GGGTGCTATGCCGATGAGGA
GGGTGCTATGCCGATGAGGA -> AGACAGGTGCCACCGTGACA
AGACAGGTGCCACCGTGACA -> AGTGCGCAATTTTCCTTACG
AGTGCGCAATTTTCCTTACG -> TACCGACTCAGCACATAACA
TACCGACTCAGCACATAACA -> AACTAGAGACAGGTGCCACC
AACTAGAGACAGGTGCCACC -> AGAGCTTGGTTGTACTGCTC
AGAGCTTGGTTGTACTGCTC -> GACAACGAATAAAAGAGTAG
GACAACGAATAAAAGAGTAG -> CCAGATAAGGGGATTGCACT
CCAGATAAGGGGATTGCACT -> TTCACGACCTGTTTCACCCA
TTCACGACCTGTTTCACCCA -> TCTTTAAAGGGGCACAACTA
TCTTTAAAGGGGCACAACTA -> AGTAAAATTTATTCGTTCTC
AGTAAAATTTATTCGTTCTC -> ACTAGTAGGAGTTAGATGTT
ACTAGTAGGAGTTAGATGTT -> AAGAAAAATATTATGACAGT
AAGAAAAATATTATGACAGT -> TCTGGCAATGGAACCACAGA
TCTGGCAATGGAACCACAGA -> TTGCACTTGAATCCGTGTAA
TTGCACTTGAATCCGTGTAA -> TAGAGACAGGTGCCACCGTG
TAGAGACAGGTGCCACCGTG -> AGCCATTACGCAGTTATATG
AGCCATTACGCAGTTATATG -> CGTCCGATCGCCGAATATGG
CGTCCGATCGCCGAATATGG -> AACGCCTATCTGGGGCTTCC
AACGCCTATCTGGGGCTTCC -> ATAACAGCCAGCAAGTAGCA
ATAACAGCCAGCAAGTAGCA -> ATACCTGTGAGATGCGAATT
ATACCTGTGAGATGCGAATT -> CCCGCGAACCAATGTGCTAG
CCCGCGAACCAATGTGCTAG -> GAAAAGGATCCTTAAAGATC
GAAAAGGATCCTTAAAGATC -> CTCAGCTACAGACTAGAAAG
CTCAGCTACAGACTAGAAAG -> CCGCGAACCAATGTGCTAGT
CCGCGAACCAATGTGCTAGT -> TAGTATGACTGGCGATGCAG
TAGTATGACTGGCGATGCAG -> GTACGGCAGAGCTTGGTTGT
GTACGGCAGAGCTTGGTTGT -> GAAAGAAAAATATTATGACA
GAAAGAAAAATATTATGACA -> GTGCCGCTAGATGGCTCGAG
GTGCCGCTAGATGGCTCGAG -> GAAAAATATTATGACAGTCA
GAAAAATATTATGACAGTCA -> GCCCATAAGAGTGCGCAATT
GCCCATAAGAGTGCGCAATT -> ATAAGAGTGCGCAATTTTCC
ATAAGAGTGCGCAATTTTCC -> AGGCGCACTAGTAGGAGTTA
AGGCGCACTAGTAGGAGTTA -> TTTATTCGTTCTCACCCGGA
TTTATTCGTTCTCACCCGGA -> GGTGGTCTTTAAAGGGGCAC
GGTGGTCTTTAAAGGGGCAC -> GGCAATGGAACCACAGACGT
GGCAATGGAACCACAGACGT -> GCGATCGACGACAACGAATA
GCGATCGACGACAACGAATA -> TTAACGCCTATCTGGGGCTT
TTAACGCCTATCTGGGGCTT -> TTTACCGACTCAGCACATAA
TTTACCGACTCAGCACATAA -> ACGAATAAAAGAGTAGGTGG
ACGAATAAAAGAGTAGGTGG -> TGAGATGCGAATTTACCGAC
TGAGATGCGAATTTACCGAC -> CGCGGAATCATATGGGTGCT
CGCGGAATCATATGGGTGCT -> TAAGGGGATTGCACTTGAAT
TAAGGGGATTGCACTTGAAT -> GCGGCAGCTCTTGTCGGCTG
GCGGCAGCTCTTGTCGGCTG -> TCGAGGTGAGCTAAACCACC
TCGAGGTGAGCTAAACCACC -> TGGAACCACAGACGTAACCC
TGGAACCACAGACGTAACCC -> TGCGCAATTTTCCTTACGGC
TGCGCAATTTTCCTTACGGC -> AGAAAAGGATCCTTAAAGAT
AGAAAAGGATCCTTAAAGAT -> CCGTATTCTTGGCGTGGTTG
CCGTATTCTTGGCGTGGTTG -> CTTGGCGTGGTTGTAGGCAT
CTTGGCGTGGTTGTAGGCAT -> CAGAGCTTGGTTGTACTGCT
CAGAGCTTGGTTGTACTGCT -> GCAGAGCTTGGTTGTACTGC
GCAGAGCTTGGTTGTACTGC -> ACGCACATGACGTATCGCAG
ACGCACATGACGTATCGCAG -> CATGACGTATCGCAGTTGAT
CATGACGTATCGCAGTTGAT -> TGGAACTGAATACCTGTGAG
TGGAACTGAATACCTGTGAG -> AGCCAGCAAGTAGCAACGGG
AGCCAGCAAGTAGCAACGGG -> AAATATTATGACAGTCAGTA
AAATATTATGACAGTCAGTA -> AAAGCTTCCCAGGTGGGCAT
AAAGCTTCCCAGGTGGGCAT -> CTGACTCCATTCGGTGGTAC
CTGACTCCATTCGGTGGTAC -> AGGGGCACAACTAGAGACAG
AGGGGCACAACTAGAGACAG -> ATCAAACGAACGCACATGAC
ATCAAACGAACGCACATGAC -> CTAGAAAGCTTCCCAGGTGG
CTAGAAAGCTTCCCAGGTGG -> CGTATTCTTGGCGTGGTTGT
CGTATTCTTGGCGTGGTTGT -> TTTCCTTACGGCGATCGACG
TTTCCTTACGGCGATCGACG -> GGTATCCTTACCTTGGTTAA
GGTATCCTTACCTTGGTTAA -> TAGGTGGTCTTTAAAGGGGC
TAGGTGGTCTTTAAAGGGGC -> TTCCTTACGGCGATCGACGA
TTCCTTACGGCGATCGACGA -> AAGTAGCAACGGGGTGCGAT
AAGTAGCAACGGGGTGCGAT -> TCGTTCTCACCCGGACTCTG
TCGTTCTCACCCGGACTCTG -> TATCTTAGCCCATAAGAGTG
TATCTTAGCCCATAAGAGTG -> TCCTTAAAGATCATTGAGAA
TCCTTAAAGATCATTGAGAA -> AACCACCCGCGAACCAATGT
AACCACCCGCGAACCAATGT -> CCACCGTGACAACGTGCTCA
CCACCGTGACAACGTGCTCA -> TCAGACTGGGGAGTATTTGG
TCAGACTGGGGAGTATTTGG -> AACCACAGACGTAACCCTTC
AACCACAGACGTAACCCTTC -> GATAAGGGGATTGCACTTGA
GATAAGGGGATTGCACTTGA -> AATCCGTGTAAAAACCTATT
AATCCGTGTAAAAACCTATT -> GCTCAAGTGGACATTAGCCA
GCTCAAGTGGACATTAGCCA -> TGCAGCGACTGTGCCGCTAG
TGCAGCGACTGTGCCGCTAG -> GAAAGCTTCCCAGGTGGGCA
GAAAGCTTCCCAGGTGGGCA -> TGCTCAAGTGGACATTAGCC
TGCTCAAGTGGACATTAGCC -> ACCAATGTGCTAGTATGACT
ACCAATGTGCTAGTATGACT -> GGTATCTTAGCCCATAAGAG
GGTATCTTAGCCCATAAGAG -> AATTTATTCGTTCTCACCCG
AATTTATTCGTTCTCACCCG -> CAGGGTATCTTAGCCCATAA
CAGGGTATCTTAGCCCATAA -> TTAAAGGGGCACAACTAGAG
TTAAAGGGGCACAACTAGAG -> GGCGTGGTTGTAGGCATCAA
GGCGTGGTTGTAGGCATCAA -> TCCTTACGGCGATCGACGAC
TCCTTACGGCGATCGACGAC -> GCATCAAACGAACGCACATG
GCATCAAACGAACGCACATG -> CGGGGTGCGATAAGAAAAGG
CGGGGTGCGATAAGAAAAGG -> GAGGTGAGCTAAACCACCCG
GAGGTGAGCTAAACCACCCG -> TCTACATAGAAGCGCGGAAT
TCTACATAGAAGCGCGGAAT -> AAAAGGATCCTTAAAGATCA
AAAAGGATCCTTAAAGATCA -> AGGATCCTTAAAGATCATTG
AGGATCCTTAAAGATCATTG -> CCTGTTTCACCCAATCCGGA
CCTGTTTCACCCAATCCGGA -> TGGACATTAGCCATTACGCA
TGGACATTAGCCATTACGCA -> CAGCAAGTAGCAACGGGGTG
CAGCAAGTAGCAACGGGGTG -> ATTAGAGCCTCAAACCCTTT
ATTAGAGCCTCAAACCCTTT -> AGGCATCAAACGAACGCACA
AGGCATCAAACGAACGCACA -> AATACGTCCGATCGCCGAAT
AATACGTCCGATCGCCGAAT -> GACTCAGCACATAACAGCCA
GACTCAGCACATAACAGCCA -> GGTGCGATAAGAAAAGGATC
GGTGCGATAAGAAAAGGATC -> CGCAGTTGATATAACTGGCG
CGCAGTTGATATAACTGGCG -> ATTAGCCATTACGCAGTTAT
ATTAGCCATTACGCAGTTAT -> CGCGGGGACGAGGCGCACTA
CGCGGGGACGAGGCGCACTA -> TAGCGGCTCAGAACTCAGCT
TAGCGGCTCAGAACTCAGCT -> AACTGAATACCTGTGAGATG
AACTGAATACCTGTGAGATG -> TATTCGTTCTCACCCGGACT
TATTCGTTCTCACCCGGACT -> AGACTAGAAAGCTTCCCAGG
AGACTAGAAAGCTTCCCAGG -> CTTGGTTAAGGGAGTTGCCC
CTTGGTTAAGGGAGTTGCCC -> AAAGGGGCACAACTAGAGAC
AAAGGGGCACAACTAGAGAC -> TCACGACCTGTTTCACCCAA
TCACGACCTGTTTCACCCAA -> CGACGACAACGAATAAAAGA
CGACGACAACGAATAAAAGA -> CGAATATGGTAGACCCTCGC
CGAATATGGTAGACCCTCGC -> AAAGGATCCTTAAAGATCAT
AAAGGATCCTTAAAGATCAT -> AATACCTGTGAGATGCGAAT
AATACCTGTGAGATGCGAAT -> TTCTTGGCGTGGTTGTAGGC
TTCTTGGCGTGGTTGTAGGC -> GGAATCCGTATTCTTGGCGT
GGAATCCGTATTCTTGGCGT -> GAAGCGCGGAATCATATGGG
GAAGCGCGGAATCATATGGG -> GAAGGCTTAGCGGCTCAGAA
GAAGGCTTAGCGGCTCAGAA -> GGCTTTTTCCCAGATAAGGG
GGCTTTTTCCCAGATAAGGG -> TTGTAGGCATCAAACGAACG
TTGTAGGCATCAAACGAACG -> CCAATGTGCTAGTATGACTG
CCAATGTGCTAGTATGACTG -> TAAGAAAAGGATCCTTAAAG
TAAGAAAAGGATCCTTAAAG -> GCGGGGACGAGGCGCACTAG
GCGGGGACGAGGCGCACTAG -> TCACCCGGACTCTGACTCCA
TCACCCGGACTCTGACTCCA -> AAGAAAAGGATCCTTAAAGA
AAGAAAAGGATCCTTAAAGA -> AAGGGGGCTATTAGAGCCTC
AAGGGGGCTATTAGAGCCTC -> ATCATATGGGTGCTATGCCG
ATCATATGGGTGCTATGCCG -> GAATACGTCCGATCGCCGAA
GAATACGTCCGATCGCCGAA -> GTTGGAACTGAATACCTGTG
GTTGGAACTGAATACCTGTG -> TGGCGATGCAGGGTATCTTA
TGGCGATGCAGGGTATCTTA -> CATTAGCCATTACGCAGTTA
CATTAGCCATTACGCAGTTA -> TTTTAGGTTACATCGACCTC
TTTTAGGTTACATCGACCTC -> AACGAATAAAAGAGTAGGTG
AACGAATAAAAGAGTAGGTG -> ACCCTTTCTTTGGAAGGCTT
ACCCTTTCTTTGGAAGGCTT -> GGCAGCTCTTGTCGGCTGGT
GGCAGCTCTTGTCGGCTGGT -> AGAACTCAGCTACAGACTAG
AGAACTCAGCTACAGACTAG -> TAAAGGGGCACAACTAGAGA
TAAAGGGGCACAACTAGAGA -> TAGTAGGAGTTAGATGTTTT
TAGTAGGAGTTAGATGTTTT -> ACATAGAAGCGCGGAATCAT
ACATAGAAGCGCGGAATCAT -> CGGAATACGTCCGATCGCCG
CGGAATACGTCCGATCGCCG -> CAGACTGGGGAGTATTTGGG
CAGACTGGGGAGTATTTGGG -> GGTTACATCGACCTCTTTCA
GGTTACATCGACCTCTTTCA -> CAATGGAACCACAGACGTAA
CAATGGAACCACAGACGTAA -> TCCCAGGTGGGCATTTAACG
TCCCAGGTGGGCATTTAACG -> GTCTTTAAAGGGGCACAACT
GTCTTTAAAGGGGCACAACT -> CTGTGCCGCTAGATGGCTCG
CTGTGCCGCTAGATGGCTCG -> CGAGGCGCACTAGTAGGAGT
CGAGGCGCACTAGTAGGAGT -> ATCCGGAATACGTCCGATCG
ATCCGGAATACGTCCGATCG -> CCCGGACTCTGACTCCATTC
CCCGGACTCTGACTCCATTC -> CTTCCACCGGCGGGGTTCTC
CTTCCACCGGCGGGGTTCTC -> CCAGAGCCTTGCAGCGACTG
CCAGAGCCTTGCAGCGACTG -> ACATTAGCCATTACGCAGTT
ACATTAGCCATTACGCAGTT -> CAGAACTCAGCTACAGACTA
CAGAACTCAGCTACAGACTA -> ACATCGACCTCTTTCAAGGG
ACATCGACCTCTTTCAAGGG -> GTTGATATAACTGGCGGCAG
GTTGATATAACTGGCGGCAG -> GGACTCTGACTCCATTCGGT
GGACTCTGACTCCATTCGGT -> CGCAATTTTCCTTACGGCGA
CGCAATTTTCCTTACGGCGA -> TAGATGGCTCGAGGTGAGCT
TAGATGGCTCGAGGTGAGCT -> CTCGCTTGTTTCGTTGGAAC
CTCGCTTGTTTCGTTGGAAC -> TGTAGGCATCAAACGAACGC
TGTAGGCATCAAACGAACGC -> TGGTCTTTAAAGGGGCACAA
TGGTCTTTAAAGGGGCACAA -> ACTGAATACCTGTGAGATGC
ACTGAATACCTGTGAGATGC -> CACCGGCGGGGTTCTCGTTC
CACCGGCGGGGTTCTCGTTC -> TACGGCAGAGCTTGGTTGTA
TACGGCAGAGCTTGGTTGTA -> CCGATGAGGAATCCGTATTC
CCGATGAGGAATCCGTATTC -> GGTTCTCGTTCACGACCTGT
GGTTCTCGTTCACGACCTGT -> AGAGACAGGTGCCACCGTGA
AGAGACAGGTGCCACCGTGA -> TGAATCCGTGTAAAAACCTA
TGAATCCGTGTAAAAACCTA -> AAAAACCTATTTCTACATAG
AAAAACCTATTTCTACATAG -> ATATGGGTGCTATGCCGATG
ATATGGGTGCTATGCCGATG -> GGGACGAGGCGCACTAGTAG
GGGACGAGGCGCACTAGTAG -> CCTTCTTCACCGACGCGGGG
CCTTCTTCACCGACGCGGGG -> ACAGACGTAACCCTTCTTCA
ACAGACGTAACCCTTCTTCA -> TACAGACTAGAAAGCTTCCC
TACAGACTAGAAAGCTTCCC -> TCGTTGGAACTGAATACCTG
TCGTTGGAACTGAATACCTG -> ATGTTTTAGGTTACATCGAC
ATGTTTTAGGTTACATCGAC -> TGCCACCGTGACAACGTGCT
TGCCACCGTGACAACGTGCT -> TAGGAGTTAGATGTTTTAGG
TAGGAGTTAGATGTTTTAGG -> CAATGTGCTAGTATGACTGG
CAATGTGCTAGTATGACTGG -> GAATCCGTATTCTTGGCGTG
GAATCCGTATTCTTGGCGTG -> CCTTAAAGATCATTGAGAAA
CCTTAAAGATCATTGAGAAA -> GGTGCCACCGTGACAACGTG
GGTGCCACCGTGACAACGTG -> ATATAACTGGCGGCAGCTCT
ATATAACTGGCGGCAGCTCT -> GCTCGAGGTGAGCTAAACCA
GCTCGAGGTGAGCTAAACCA -> TTGGGCTTTTTCCCAGATAA
TTGGGCTTTTTCCCAGATAA -> TCAAGTGGACATTAGCCATT
TCAAGTGGACATTAGCCATT -> ATTCGTTCTCACCCGGACTC
ATTCGTTCTCACCCGGACTC -> GCTTCCCAGGTGGGCATTTA
GCTTCCCAGGTGGGCATTTA -> CAAACCCGCGGTATCCTTAC
CAAACCCGCGGTATCCTTAC -> TTGTTTCGTTGGAACTGAAT
TTGTTTCGTTGGAACTGAAT -> TTCCCAGATAAGGGGATTGC
TTCCCAGATAAGGGGATTGC -> AAGATCATTGAGAAAGAAAA
AAGATCATTGAGAAAGAAAA -> TATGGGTGCTATGCCGATGA
TATGGGTGCTATGCCGATGA -> AAGGGGATTGCACTTGAATC
AAGGGGATTGCACTTGAATC -> ACAGGTGCCACCGTGACAAC
ACAGGTGCCACCGTGACAAC -> GAGCCTTGCAGCGACTGTGC
GAGCCTTGCAGCGACTGTGC -> AGGGTAAATTCAAACCCGCG
AGGGTAAATTCAAACCCGCG -> CGGGGTTCTCGTTCACGACC
CGGGGTTCTCGTTCACGACC -> CCTTACCTTGGTTAAGGGAG
CCTTACCTTGGTTAAGGGAG -> TCCGTATTCTTGGCGTGGTT
TCCGTATTCTTGGCGTGGTT -> ACGGCAGAGCTTGGTTGTAC
ACGGCAGAGCTTGGTTGTAC -> TCATATGGGTGCTATGCCGA
TCATATGGGTGCTATGCCGA -> GCTAAACCACCCGCGAACCA
GCTAAACCACCCGCGAACCA -> TTTTCCTTACGGCGATCGAC
TTTTCCTTACGGCGATCGAC -> ATGGGTGCTATGCCGATGAG
ATGGGTGCTATGCCGATGAG -> GTGCCACCGTGACAACGTGC
GTGCCACCGTGACAACGTGC -> TTCGGTGGTACGGCAGAGCT
TTCGGTGGTACGGCAGAGCT -> CATTTAACGCCTATCTGGGG
CATTTAACGCCTATCTGGGG -> TACTGCTCAAGTGGACATTA
TACTGCTCAAGTGGACATTA -> CCGTGTAAAAACCTATTTCT
CCGTGTAAAAACCTATTTCT -> AGCAAGTAGCAACGGGGTGC
AGCAAGTAGCAACGGGGTGC -> TTAGCCATTACGCAGTTATA
TTAGCCATTACGCAGTTATA -> ACCGTGACAACGTGCTCAGA
ACCGTGACAACGTGCTCAGA -> ATTCAAACCCGCGGTATCCT
ATTCAAACCCGCGGTATCCT -> GCTACAGACTAGAAAGCTTC
GCTACAGACTAGAAAGCTTC -> AGAGTAGGTGGTCTTTAAAG
AGAGTAGGTGGTCTTTAAAG -> AATTCAAACCCGCGGTATCC
AATTCAAACCCGCGGTATCC -> GCAGCGACTGTGCCGCTAGA
GCAGCGACTGTGCCGCTAGA -> GTTTTAGGTTACATCGACCT
GTTTTAGGTTACATCGACCT -> CTTTTTCCCAGATAAGGGGA
CTTTTTCCCAGATAAGGGGA -> GCCTCAAACCCTTTCTTTGG
GCCTCAAACCCTTTCTTTGG -> GAACCAATGTGCTAGTATGA
GAACCAATGTGCTAGTATGA -> TCTTCACCGACGCGGGGACG
TCTTCACCGACGCGGGGACG -> TTAGCGGCTCAGAACTCAGC
TTAGCGGCTCAGAACTCAGC -> TGGTCGCATCTCTGGCAATG
TGGTCGCATCTCTGGCAATG -> CTGAATACCTGTGAGATGCG
CTGAATACCTGTGAGATGCG -> TTCTACATAGAAGCGCGGAA
TTCTACATAGAAGCGCGGAA -> CCCTTCTTCACCGACGCGGG
CCCTTCTTCACCGACGCGGG -> CGTGGTTGTAGGCATCAAAC
CGTGGTTGTAGGCATCAAAC -> GACATTAGCCATTACGCAGT
GACATTAGCCATTACGCAGT -> CTGTTTCACCCAATCCGGAA
CTGTTTCACCCAATCCGGAA -> AGGAGTTAGATGTTTTAGGT
AGGAGTTAGATGTTTTAGGT -> GTGGTACGGCAGAGCTTGGT
GTGGTACGGCAGAGCTTGGT -> AGAGCCTCAAACCCTTTCTT
AGAGCCTCAAACCCTTTCTT -> GTAGGGTAAATTCAAACCCG
GTAGGGTAAATTCAAACCCG -> CGGAATCATATGGGTGCTAT
CGGAATCATATGGGTGCTAT -> GCCAGCAAGTAGCAACGGGG
GCCAGCAAGTAGCAACGGGG -> CAGCTCTTGTCGGCTGGTCG
CAGCTCTTGTCGGCTGGTCG -> CGCTTGTTTCGTTGGAACTG
CGCTTGTTTCGTTGGAACTG -> CGATCGCCGAATATGGTAGA
CGATCGCCGAATATGGTAGA -> ACTGGCGATGCAGGGTATCT
ACTGGCGATGCAGGGTATCT -> CTTACGGCGATCGACGACAA
CTTACGGCGATCGACGACAA -> GGATTGCACTTGAATCCGTG
GGATTGCACTTGAATCCGTG -> TGGCAATGGAACCACAGACG
TGGCAATGGAACCACAGACG -> GCCTATCTGGGGCTTCCACC
GCCTATCTGGGGCTTCCACC -> CAGGTGGGCATTTAACGCCT
CAGGTGGGCATTTAACGCCT -> CTTACCTTGGTTAAGGGAGT
CTTACCTTGGTTAAGGGAGT -> TATAACTGGCGGCAGCTCTT
TATAACTGGCGGCAGCTCTT -> CATTGAGAAAGAAAAATATT
CATTGAGAAAGAAAAATATT -> ATTGCACTTGAATCCGTGTA
ATTGCACTTGAATCCGTGTA -> TAGAAAGCTTCCCAGGTGGG
TAGAAAGCTTCCCAGGTGGG -> TCGGTGGTACGGCAGAGCTT
TCGGTGGTACGGCAGAGCTT -> AGACCCTCGCTTGTTTCGTT
AGACCCTCGCTTGTTTCGTT -> GCAACGGGGTGCGATAAGAA
GCAACGGGGTGCGATAAGAA -> CGACCTGTTTCACCCAATCC
CGACCTGTTTCACCCAATCC -> GACGCGGGGACGAGGCGCAC
GACGCGGGGACGAGGCGCAC -> ACTAGAAAGCTTCCCAGGTG
ACTAGAAAGCTTCCCAGGTG -> TAACTGGCGGCAGCTCTTGT
TAACTGGCGGCAGCTCTTGT -> GCTATGCCGATGAGGAATCC
GCTATGCCGATGAGGAATCC -> CCTTTCTTTGGAAGGCTTAG
CCTTTCTTTGGAAGGCTTAG -> GACTCCATTCGGTGGTACGG
GACTCCATTCGGTGGTACGG -> GTCAGTAAAATTTATTCGTT
GTCAGTAAAATTTATTCGTT -> CGGCTCAGAACTCAGCTACA
CGGCTCAGAACTCAGCTACA -> GCACATAACAGCCAGCAAGT
GCACATAACAGCCAGCAAGT -> AGCCCATAAGAGTGCGCAAT
AGCCCATAAGAGTGCGCAAT -> GCACTTGAATCCGTGTAAAA
GCACTTGAATCCGTGTAAAA -> AAAATATTATGACAGTCAGT
AAAATATTATGACAGTCAGT -> CAATCCGGAATACGTCCGAT
CAATCCGGAATACGTCCGAT -> GCACATGACGTATCGCAGTT
GCACATGACGTATCGCAGTT -> CCTTGCAGCGACTGTGCCGC
CCTTGCAGCGACTGTGCCGC -> ATTTCTACATAGAAGCGCGG
ATTTCTACATAGAAGCGCGG -> TCTGGGGCTTCCACCGGCGG
TCTGGGGCTTCCACCGGCGG -> TGACAACGTGCTCAGACTGG
TGACAACGTGCTCAGACTGG -> TCCGATCGCCGAATATGGTA
TCCGATCGCCGAATATGGTA -> TTGAATCCGTGTAAAAACCT
TTGAATCCGTGTAAAAACCT -> TGCTATGCCGATGAGGAATC
TGCTATGCCGATGAGGAATC -> TAGCAACGGGGTGCGATAAG
TAGCAACGGGGTGCGATAAG -> CTTAGCGGCTCAGAACTCAG
CTTAGCGGCTCAGAACTCAG -> CAACGTGCTCAGACTGGGGA
CAACGTGCTCAGACTGGGGA -> CTCAGCACATAACAGCCAGC
CTCAGCACATAACAGCCAGC -> CTGTGAGATGCGAATTTACC
CTGTGAGATGCGAATTTACC -> TTATTCGTTCTCACCCGGAC
TTATTCGTTCTCACCCGGAC -> ATCGACGACAACGAATAAAA
ATCGACGACAACGAATAAAA -> CCATTCGGTGGTACGGCAGA
CCATTCGGTGGTACGGCAGA -> TTCCACCGGCGGGGTTCTCG
TTCCACCGGCGGGGTTCTCG -> GAGCTTGGTTGTACTGCTCA
GAGCTTGGTTGTACTGCTCA -> TGCCGATGAGGAATCCGTAT
TGCCGATGAGGAATCCGTAT -> GCACTAGTAGGAGTTAGATG
GCACTAGTAGGAGTTAGATG -> CCACAGACGTAACCCTTCTT
CCACAGACGTAACCCTTCTT -> CGCGAACCAATGTGCTAGTA
CGCGAACCAATGTGCTAGTA -> CTAGAGACAGGTGCCACCGT
CTAGAGACAGGTGCCACCGT -> GGGGACGAGGCGCACTAGTA
GGGGACGAGGCGCACTAGTA -> GCCACCGTGACAACGTGCTC
GCCACCGTGACAACGTGCTC -> TACCTTGGTTAAGGGAGTTG
TACCTTGGTTAAGGGAGTTG -> TTGGAAGGCTTAGCGGCTCA
TTGGAAGGCTTAGCGGCTCA -> TCTTTGGAAGGCTTAGCGGC
TCTTTGGAAGGCTTAGCGGC -> AAATTTATTCGTTCTCACCC
AAATTTATTCGTTCTCACCC -> CTGGCAATGGAACCACAGAC
CTGGCAATGGAACCACAGAC -> AACCCGCGGTATCCTTACCT
AACCCGCGGTATCCTTACCT -> ACCTGTGAGATGCGAATTTA
ACCTGTGAGATGCGAATTTA -> AATCCGGAATACGTCCGATC
AATCCGGAATACGTCCGATC -> ATAACTGGCGGCAGCTCTTG
ATAACTGGCGGCAGCTCTTG -> CTCTGACTCCATTCGGTGGT
CTCTGACTCCATTCGGTGGT -> GGAACTGAATACCTGTGAGA
GGAACTGAATACCTGTGAGA -> CTATTTCTACATAGAAGCGC
CTATTTCTACATAGAAGCGC -> TCGCCGAATATGGTAGACCC
TCGCCGAATATGGTAGACCC -> ACCCTCGCTTGTTTCGTTGG
ACCCTCGCTTGTTTCGTTGG -> GACCTCTTTCAAGGGGGCTA
GACCTCTTTCAAGGGGGCTA -> GCTTGGTTGTACTGCTCAAG
GCTTGGTTGTACTGCTCAAG -> GGAACCACAGACGTAACCCT
GGAACCACAGACGTAACCCT -> CTTGCAGCGACTGTGCCGCT
CTTGCAGCGACTGTGCCGCT -> TCAGTAAAATTTATTCGTTC
TCAGTAAAATTTATTCGTTC -> CATCGACCTCTTTCAAGGGG
CATCGACCTCTTTCAAGGGG -> CACCCAATCCGGAATACGTC
CACCCAATCCGGAATACGTC -> GCATCTCTGGCAATGGAACC
GCATCTCTGGCAATGGAACC -> ATGGAACCACAGACGTAACC
ATGGAACCACAGACGTAACC -> ATTGAGAAAGAAAAATATTA
ATTGAGAAAGAAAAATATTA -> CGTATCGCAGTTGATATAAC
CGTATCGCAGTTGATATAAC -> CCGTGACAACGTGCTCAGAC
CCGTGACAACGTGCTCAGAC -> AGCACATAACAGCCAGCAAG
AGCACATAACAGCCAGCAAG -> AGCCTTGCAGCGACTGTGCC
AGCCTTGCAGCGACTGTGCC -> CAGCTACAGACTAGAAAGCT
CAGCTACAGACTAGAAAGCT -> TTGTACTGCTCAAGTGGACA
TTGTACTGCTCAAGTGGACA -> GACAACGTGCTCAGACTGGG
GACAACGTGCTCAGACTGGG -> ACCCGCGGTATCCTTACCTT
ACCCGCGGTATCCTTACCTT -> ATTATGACAGTCAGTAAAAT
ATTATGACAGTCAGTAAAAT -> GAACTCAGCTACAGACTAGA
GAACTCAGCTACAGACTAGA -> GTTCACGACCTGTTTCACCC
GTTCACGACCTGTTTCACCC -> ATGCCGATGAGGAATCCGTA
ATGCCGATGAGGAATCCGTA -> GTATGACTGGCGATGCAGGG
GTATGACTGGCGATGCAGGG -> TTCTTTGGAAGGCTTAGCGG
TTCTTTGGAAGGCTTAGCGG -> AAAAATATTATGACAGTCAG
AAAAATATTATGACAGTCAG -> TTTAGGTTACATCGACCTCT
TTTAGGTTACATCGACCTCT -> TTTCAAGGGGGCTATTAGAG
TTTCAAGGGGGCTATTAGAG -> GATCATTGAGAAAGAAAAAT
GATCATTGAGAAAGAAAAAT -> TCTTGGCGTGGTTGTAGGCA
TCTTGGCGTGGTTGTAGGCA -> ACCTCTTTCAAGGGGGCTAT
ACCTCTTTCAAGGGGGCTAT -> TCGGCTGGTCGCATCTCTGG
TCGGCTGGTCGCATCTCTGG -> GACAGTCAGTAAAATTTATT
GACAGTCAGTAAAATTTATT -> CGCAGTTATATGTAGGGTAA
CGCAGTTATATGTAGGGTAA -> TTCTCGTTCACGACCTGTTT
TTCTCGTTCACGACCTGTTT -> CCGAATATGGTAGACCCTCG
CCGAATATGGTAGACCCTCG -> GACCCTCGCTTGTTTCGTTG
GACCCTCGCTTGTTTCGTTG -> AAGGCTTAGCGGCTCAGAAC
AAGGCTTAGCGGCTCAGAAC -> CAAGTGGACATTAGCCATTA
CAAGTGGACATTAGCCATTA -> GCGCGGAATCATATGGGTGC
GCGCGGAATCATATGGGTGC -> TGGGCATTTAACGCCTATCT
TGGGCATTTAACGCCTATCT -> ACAACTAGAGACAGGTGCCA
ACAACTAGAGACAGGTGCCA -> GGTACGGCAGAGCTTGGTTG
GGTACGGCAGAGCTTGGTTG -> GGACATTAGCCATTACGCAG
GGACATTAGCCATTACGCAG -> GAGAAAGAAAAATATTATGA
GAGAAAGAAAAATATTATGA -> CTCAGAACTCAGCTACAGAC
CTCAGAACTCAGCTACAGAC -> GCGACTGTGCCGCTAGATGG
GCGACTGTGCCGCTAGATGG -> GAGGAATCCGTATTCTTGGC
GAGGAATCCGTATTCTTGGC -> TGTGCCGCTAGATGGCTCGA
TGTGCCGCTAGATGGCTCGA -> GCTAGATGGCTCGAGGTGAG
GCTAGATGGCTCGAGGTGAG -> GTGAGATGCGAATTTACCGA
GTGAGATGCGAATTTACCGA -> ACCCGGACTCTGACTCCATT
ACCCGGACTCTGACTCCATT -> CCGGACTCTGACTCCATTCG
CCGGACTCTGACTCCATTCG -> GGAATACGTCCGATCGCCGA
GGAATACGTCCGATCGCCGA -> AGATGTTTTAGGTTACATCG
AGATGTTTTAGGTTACATCG -> TCCATTCGGTGGTACGGCAG
TCCATTCGGTGGTACGGCAG -> CTCAAGTGGACATTAGCCAT
CTCAAGTGGACATTAGCCAT -> GCTGGTCGCATCTCTGGCAA
GCTGGTCGCATCTCTGGCAA -> GCATTTAACGCCTATCTGGG
GCATTTAACGCCTATCTGGG -> CTGGTCGCATCTCTGGCAAT
CTGGTCGCATCTCTGGCAAT -> GGAATCATATGGGTGCTATG
GGAATCATATGGGTGCTATG -> AAGCTTCCCAGGTGGGCATT
AAGCTTCCCAGGTGGGCATT -> CGCACATGACGTATCGCAGT
CGCACATGACGTATCGCAGT -> GGCGGCAGCTCTTGTCGGCT
GGCGGCAGCTCTTGTCGGCT -> GGGTAAATTCAAACCCGCGG
GGGTAAATTCAAACCCGCGG -> CTCTTTCAAGGGGGCTATTA
CTCTTTCAAGGGGGCTATTA -> TCCGTGTAAAAACCTATTTC
TCCGTGTAAAAACCTATTTC -> GGGGCTATTAGAGCCTCAAA
GGGGCTATTAGAGCCTCAAA -> ACCGACGCGGGGACGAGGCG
ACCGACGCGGGGACGAGGCG -> ATCCGTGTAAAAACCTATTT
