CAGCAACGACC -> AGCAACGACCA
AGCAACGACCA -> GCAACGACCAG
GCAACGACCAG -> CAACGACCAGC
CAACGACCAGC -> AACGACCAGCA
AACGACCAGCA -> ACGACCAGCAT
ACGACCAGCAT -> CGACCAGCATT
CGACCAGCATT -> GACCAGCATTT
GACCAGCATTT -> ACCAGCATTTG
ACCAGCATTTG -> CCAGCATTTGC
CCAGCATTTGC -> CAGCATTTGCT
CAGCATTTGCT -> AGCATTTGCTC
AGCATTTGCTC -> GCATTTGCTCT
GCATTTGCTCT -> CATTTGCTCTA
CATTTGCTCTA -> ATTTGCTCTAC
ATTTGCTCTAC -> TTTGCTCTACC
TTTGCTCTACC -> TTGCTCTACCG
TTGCTCTACCG -> TGCTCTACCGA
TGCTCTACCGA -> GCTCTACCGAC
GCTCTACCGAC -> CTCTACCGACA
CTCTACCGACA -> TCTACCGACAA
TCTACCGACAA -> CTACCGACAAA
CTACCGACAAA -> TACCGACAAAG
TACCGACAAAG -> ACCGACAAAGC
ACCGACAAAGC -> CCGACAAAGCT
CCGACAAAGCT -> CGACAAAGCTA
CGACAAAGCTA -> GACAAAGCTAT
GACAAAGCTAT -> ACAAAGCTATG
ACAAAGCTATG -> CAAAGCTATGC
CAAAGCTATGC -> AAAGCTATGCT
AAAGCTATGCT -> AAGCTATGCTG
AAGCTATGCTG -> AGCTATGCTGC
AGCTATGCTGC -> GCTATGCTGCT
GCTATGCTGCT -> CTATGCTGCTC
CTATGCTGCTC -> TATGCTGCTCA
TATGCTGCTCA -> ATGCTGCTCAT
ATGCTGCTCAT -> TGCTGCTCATC
TGCTGCTCATC -> GCTGCTCATCC
GCTGCTCATCC -> CTGCTCATCCC
CTGCTCATCCC -> TGCTCATCCCG
TGCTCATCCCG -> GCTCATCCCGA
GCTCATCCCGA -> CTCATCCCGAG
CTCATCCCGAG -> TCATCCCGAGA
TCATCCCGAGA -> CATCCCGAGAC
CATCCCGAGAC -> ATCCCGAGACT
ATCCCGAGACT -> TCCCGAGACTA
TCCCGAGACTA -> CCCGAGACTAA
CCCGAGACTAA -> CCGAGACTAAT
CCGAGACTAAT -> CGAGACTAATA
CGAGACTAATA -> GAGACTAATAA
GAGACTAATAA -> AGACTAATAAT
AGACTAATAAT -> GACTAATAATC
GACTAATAATC -> ACTAATAATCA
ACTAATAATCA -> CTAATAATCAA
CTAATAATCAA -> TAATAATCAAC
TAATAATCAAC -> AATAATCAACT
AATAATCAACT -> ATAATCAACTT
ATAATCAACTT -> TAATCAACTTG
TAATCAACTTG -> AATCAACTTGA
AATCAACTTGA -> ATCAACTTGAT
ATCAACTTGAT -> TCAACTTGATA
TCAACTTGATA -> CAACTTGATAT
CAACTTGATAT -> AACTTGATATA
AACTTGATATA -> ACTTGATATAA
ACTTGATATAA -> CTTGATATAAA
CTTGATATAAA -> TTGATATAAAT
TTGATATAAAT -> TGATATAAATG
TGATATAAATG -> GATATAAATGG
GATATAAATGG -> ATATAAATGGC
ATATAAATGGC -> TATAAATGGCC
TATAAATGGCC -> ATAAATGGCCA
ATAAATGGCCA -> TAAATGGCCAT
TAAATGGCCAT -> AAATGGCCATA
AAATGGCCATA -> AATGGCCATAT
AATGGCCATAT -> ATGGCCATATA
ATGGCCATATA -> TGGCCATATAT
TGGCCATATAT -> GGCCATATATG
GGCCATATATG -> GCCATATATGA
GCCATATATGA -> CCATATATGAG
CCATATATGAG -> CATATATGAGG
CATATATGAGG -> ATATATGAGGA
ATATATGAGGA -> TATATGAGGAG
TATATGAGGAG -> ATATGAGGAGC
ATATGAGGAGC -> TATGAGGAGCT
TATGAGGAGCT -> ATGAGGAGCTC
ATGAGGAGCTC -> TGAGGAGCTCT
TGAGGAGCTCT -> GAGGAGCTCTG
GAGGAGCTCTG -> AGGAGCTCTGC
AGGAGCTCTGC -> GGAGCTCTGCG
GGAGCTCTGCG -> GAGCTCTGCGT
GAGCTCTGCGT -> AGCTCTGCGTT
AGCTCTGCGTT -> GCTCTGCGTTG
GCTCTGCGTTG -> CTCTGCGTTGG
CTCTGCGTTGG -> TCTGCGTTGGG
TCTGCGTTGGG -> CTGCGTTGGGC
CTGCGTTGGGC -> TGCGTTGGGCG
TGCGTTGGGCG -> GCGTTGGGCGT
GCGTTGGGCGT -> CGTTGGGCGTG
CGTTGGGCGTG -> GTTGGGCGTGG
GTTGGGCGTGG -> TTGGGCGTGGC
TTGGGCGTGGC -> TGGGCGTGGCT
TGGGCGTGGCT -> GGGCGTGGCTA
GGGCGTGGCTA -> GGCGTGGCTAA
GGCGTGGCTAA -> GCGTGGCTAAT
GCGTGGCTAAT -> CGTGGCTAATC
CGTGGCTAATC -> GTGGCTAATCC
GTGGCTAATCC -> TGGCTAATCCT
TGGCTAATCCT -> GGCTAATCCTG
GGCTAATCCTG -> GCTAATCCTGC
GCTAATCCTGC -> CTAATCCTGCA
CTAATCCTGCA -> TAATCCTGCAT
TAATCCTGCAT -> AATCCTGCATG
AATCCTGCATG -> ATCCTGCATGT
ATCCTGCATGT -> TCCTGCATGTC
TCCTGCATGTC -> CCTGCATGTCT
CCTGCATGTCT -> CTGCATGTCTT
CTGCATGTCTT -> TGCATGTCTTT
TGCATGTCTTT -> GCATGTCTTTT
GCATGTCTTTT -> CATGTCTTTTT
CATGTCTTTTT -> ATGTCTTTTTG
ATGTCTTTTTG -> TGTCTTTTTGA
TGTCTTTTTGA -> GTCTTTTTGAC
GTCTTTTTGAC -> TCTTTTTGACG
TCTTTTTGACG -> CTTTTTGACGC
CTTTTTGACGC -> TTTTTGACGCC
TTTTTGACGCC -> TTTTGACGCCC
TTTTGACGCCC -> TTTGACGCCCC
TTTGACGCCCC -> TTGACGCCCCG
TTGACGCCCCG -> TGACGCCCCGC
TGACGCCCCGC -> GACGCCCCGCC
GACGCCCCGCC -> ACGCCCCGCCG
ACGCCCCGCCG -> CGCCCCGCCGG
CGCCCCGCCGG -> GCCCCGCCGGA
GCCCCGCCGGA -> CCCCGCCGGAG
CCCCGCCGGAG -> CCCGCCGGAGC
CCCGCCGGAGC -> CCGCCGGAGCA
CCGCCGGAGCA -> CGCCGGAGCAC
CGCCGGAGCAC -> GCCGGAGCACC
GCCGGAGCACC -> CCGGAGCACCC
CCGGAGCACCC -> CGGAGCACCCC
CGGAGCACCCC -> GGAGCACCCCT
GGAGCACCCCT -> GAGCACCCCTT
GAGCACCCCTT -> AGCACCCCTTT
AGCACCCCTTT -> GCACCCCTTTG
GCACCCCTTTG -> CACCCCTTTGG
CACCCCTTTGG -> ACCCCTTTGGC
ACCCCTTTGGC -> CCCCTTTGGCA
CCCCTTTGGCA -> CCCTTTGGCAA
CCCTTTGGCAA -> CCTTTGGCAAG
CCTTTGGCAAG -> CTTTGGCAAGT
CTTTGGCAAGT -> TTTGGCAAGTG
TTTGGCAAGTG -> TTGGCAAGTGG
TTGGCAAGTGG -> TGGCAAGTGGA
TGGCAAGTGGA -> GGCAAGTGGAC
GGCAAGTGGAC -> GCAAGTGGACT
GCAAGTGGACT -> CAAGTGGACTG
CAAGTGGACTG -> AAGTGGACTGA
AAGTGGACTGA -> AGTGGACTGAG
AGTGGACTGAG -> GTGGACTGAGC
GTGGACTGAGC -> TGGACTGAGCT
TGGACTGAGCT -> GGACTGAGCTA
GGACTGAGCTA -> GACTGAGCTAT
GACTGAGCTAT -> ACTGAGCTATT
ACTGAGCTATT -> CTGAGCTATTT
CTGAGCTATTT -> TGAGCTATTTG
TGAGCTATTTG -> GAGCTATTTGG
GAGCTATTTGG -> AGCTATTTGGA
AGCTATTTGGA -> GCTATTTGGAG
GCTATTTGGAG -> CTATTTGGAGG
CTATTTGGAGG -> TATTTGGAGGA
TATTTGGAGGA -> ATTTGGAGGAT
ATTTGGAGGAT -> TTTGGAGGATG
TTTGGAGGATG -> TTGGAGGATGT
TTGGAGGATGT -> TGGAGGATGTT
TGGAGGATGTT -> GGAGGATGTTG
GGAGGATGTTG -> GAGGATGTTGA
GAGGATGTTGA -> AGGATGTTGAC
AGGATGTTGAC -> GGATGTTGACG
GGATGTTGACG -> GATGTTGACGA
GATGTTGACGA -> ATGTTGACGAA
ATGTTGACGAA -> TGTTGACGAAC
TGTTGACGAAC -> GTTGACGAACG
GTTGACGAACG -> TTGACGAACGC
TTGACGAACGC -> TGACGAACGCG
TGACGAACGCG -> GACGAACGCGT
GACGAACGCGT -> ACGAACGCGTG
ACGAACGCGTG -> CGAACGCGTGC
CGAACGCGTGC -> GAACGCGTGCG
GAACGCGTGCG -> AACGCGTGCGG
AACGCGTGCGG -> ACGCGTGCGGA
ACGCGTGCGGA -> CGCGTGCGGAC
CGCGTGCGGAC -> GCGTGCGGACG
GCGTGCGGACG -> CGTGCGGACGC
CGTGCGGACGC -> GTGCGGACGCG
GTGCGGACGCG -> TGCGGACGCGT
TGCGGACGCGT -> GCGGACGCGTT
GCGGACGCGTT -> CGGACGCGTTC
CGGACGCGTTC -> GGACGCGTTCA
GGACGCGTTCA -> GACGCGTTCAA
GACGCGTTCAA -> ACGCGTTCAAT
ACGCGTTCAAT -> CGCGTTCAATA
CGCGTTCAATA -> GCGTTCAATAG
GCGTTCAATAG -> CGTTCAATAGA
CGTTCAATAGA -> GTTCAATAGAC
GTTCAATAGAC -> TTCAATAGACG
TTCAATAGACG -> TCAATAGACGC
TCAATAGACGC -> CAATAGACGCA
CAATAGACGCA -> AATAGACGCAC
AATAGACGCAC -> ATAGACGCACG
ATAGACGCACG -> TAGACGCACGC
TAGACGCACGC -> AGACGCACGCT
AGACGCACGCT -> GACGCACGCTC
GACGCACGCTC -> ACGCACGCTCG
ACGCACGCTCG -> CGCACGCTCGG
CGCACGCTCGG -> GCACGCTCGGG
GCACGCTCGGG -> CACGCTCGGGG
CACGCTCGGGG -> ACGCTCGGGGC
ACGCTCGGGGC -> CGCTCGGGGCG
CGCTCGGGGCG -> GCTCGGGGCGC
GCTCGGGGCGC -> CTCGGGGCGCA
CTCGGGGCGCA -> TCGGGGCGCAG
TCGGGGCGCAG -> CGGGGCGCAGT
CGGGGCGCAGT -> GGGGCGCAGTA
GGGGCGCAGTA -> GGGCGCAGTAC
GGGCGCAGTAC -> GGCGCAGTACC
GGCGCAGTACC -> GCGCAGTACCT
GCGCAGTACCT -> CGCAGTACCTA
CGCAGTACCTA -> GCAGTACCTAG
GCAGTACCTAG -> CAGTACCTAGC
CAGTACCTAGC -> AGTACCTAGCG
AGTACCTAGCG -> GTACCTAGCGG
GTACCTAGCGG -> TACCTAGCGGT
TACCTAGCGGT -> ACCTAGCGGTT
ACCTAGCGGTT -> CCTAGCGGTTC
CCTAGCGGTTC -> CTAGCGGTTCC
CTAGCGGTTCC -> TAGCGGTTCCC
TAGCGGTTCCC -> AGCGGTTCCCT
AGCGGTTCCCT -> GCGGTTCCCTT
GCGGTTCCCTT -> CGGTTCCCTTC
CGGTTCCCTTC -> GGTTCCCTTCA
GGTTCCCTTCA -> GTTCCCTTCAC
GTTCCCTTCAC -> TTCCCTTCACG
TTCCCTTCACG -> TCCCTTCACGG
TCCCTTCACGG -> CCCTTCACGGG
CCCTTCACGGG -> CCTTCACGGGT
CCTTCACGGGT -> CTTCACGGGTA
CTTCACGGGTA -> TTCACGGGTAA
TTCACGGGTAA -> TCACGGGTAAG
TCACGGGTAAG -> CACGGGTAAGA
CACGGGTAAGA -> ACGGGTAAGAC
ACGGGTAAGAC -> CGGGTAAGACG
CGGGTAAGACG -> GGGTAAGACGC
GGGTAAGACGC -> GGTAAGACGCT
GGTAAGACGCT -> GTAAGACGCTT
GTAAGACGCTT -> TAAGACGCTTG
TAAGACGCTTG -> AAGACGCTTGT
AAGACGCTTGT -> AGACGCTTGTT
AGACGCTTGTT -> GACGCTTGTTA
GACGCTTGTTA -> ACGCTTGTTAT
ACGCTTGTTAT -> CGCTTGTTATA
CGCTTGTTATA -> GCTTGTTATAA
GCTTGTTATAA -> CTTGTTATAAA
CTTGTTATAAA -> TTGTTATAAAA
TTGTTATAAAA -> TGTTATAAAAC
TGTTATAAAAC -> GTTATAAAACG
GTTATAAAACG -> TTATAAAACGC
TTATAAAACGC -> TATAAAACGCC
TATAAAACGCC -> ATAAAACGCCA
ATAAAACGCCA -> TAAAACGCCAT
TAAAACGCCAT -> AAAACGCCATT
AAAACGCCATT -> AAACGCCATTC
AAACGCCATTC -> AACGCCATTCG
AACGCCATTCG -> ACGCCATTCGA
ACGCCATTCGA -> CGCCATTCGAA
CGCCATTCGAA -> GCCATTCGAAG
GCCATTCGAAG -> CCATTCGAAGG
CCATTCGAAGG -> CATTCGAAGGA
CATTCGAAGGA -> ATTCGAAGGAA
ATTCGAAGGAA -> TTCGAAGGAAT
TTCGAAGGAAT -> TCGAAGGAATG
TCGAAGGAATG -> CGAAGGAATGA
CGAAGGAATGA -> GAAGGAATGAT
GAAGGAATGAT -> AAGGAATGATG
AAGGAATGATG -> AGGAATGATGT
AGGAATGATGT -> GGAATGATGTA
GGAATGATGTA -> GAATGATGTAA
GAATGATGTAA -> AATGATGTAAT
AATGATGTAAT -> ATGATGTAATA
ATGATGTAATA -> TGATGTAATAG
TGATGTAATAG -> GATGTAATAGC
GATGTAATAGC -> ATGTAATAGCC
ATGTAATAGCC -> TGTAATAGCCA
TGTAATAGCCA -> GTAATAGCCAT
GTAATAGCCAT -> TAATAGCCATA
TAATAGCCATA -> AATAGCCATAG
AATAGCCATAG -> ATAGCCATAGG
ATAGCCATAGG -> TAGCCATAGGC
TAGCCATAGGC -> AGCCATAGGCA
AGCCATAGGCA -> GCCATAGGCAA
GCCATAGGCAA -> CCATAGGCAAG
CCATAGGCAAG -> CATAGGCAAGG
CATAGGCAAGG -> ATAGGCAAGGT
ATAGGCAAGGT -> TAGGCAAGGTC
TAGGCAAGGTC -> AGGCAAGGTCA
AGGCAAGGTCA -> GGCAAGGTCAT
GGCAAGGTCAT -> GCAAGGTCATA
GCAAGGTCATA -> CAAGGTCATAA
CAAGGTCATAA -> AAGGTCATAAG
AAGGTCATAAG -> AGGTCATAAGA
AGGTCATAAGA -> GGTCATAAGAA
GGTCATAAGAA -> GTCATAAGAAC
GTCATAAGAAC -> TCATAAGAACT
TCATAAGAACT -> CATAAGAACTA
CATAAGAACTA -> ATAAGAACTAA
ATAAGAACTAA -> TAAGAACTAAC
TAAGAACTAAC -> AAGAACTAACG
AAGAACTAACG -> AGAACTAACGA
AGAACTAACGA -> GAACTAACGAT
GAACTAACGAT -> AACTAACGATA
AACTAACGATA -> ACTAACGATAG
ACTAACGATAG -> CTAACGATAGT
CTAACGATAGT -> TAACGATAGTG
TAACGATAGTG -> AACGATAGTGG
AACGATAGTGG -> ACGATAGTGGC
ACGATAGTGGC -> CGATAGTGGCG
CGATAGTGGCG -> GATAGTGGCGA
GATAGTGGCGA -> ATAGTGGCGAC
ATAGTGGCGAC -> TAGTGGCGACT
TAGTGGCGACT -> AGTGGCGACTT
AGTGGCGACTT -> GTGGCGACTTA
GTGGCGACTTA -> TGGCGACTTAG
TGGCGACTTAG -> GGCGACTTAGC
GGCGACTTAGC -> GCGACTTAGCC
GCGACTTAGCC -> CGACTTAGCCA
CGACTTAGCCA -> GACTTAGCCAC
GACTTAGCCAC -> ACTTAGCCACG
ACTTAGCCACG -> CTTAGCCACGA
CTTAGCCACGA -> TTAGCCACGAA
TTAGCCACGAA -> TAGCCACGAAA
TAGCCACGAAA -> AGCCACGAAAA
AGCCACGAAAA -> GCCACGAAAAT
GCCACGAAAAT -> CCACGAAAATC
CCACGAAAATC -> CACGAAAATCT
CACGAAAATCT -> ACGAAAATCTG
ACGAAAATCTG -> CGAAAATCTGA
CGAAAATCTGA -> GAAAATCTGAT
GAAAATCTGAT -> AAAATCTGATA
AAAATCTGATA -> AAATCTGATAC
AAATCTGATAC -> AATCTGATACC
AATCTGATACC -> ATCTGATACCG
ATCTGATACCG -> TCTGATACCGC
TCTGATACCGC -> CTGATACCGCA
CTGATACCGCA -> TGATACCGCAT
TGATACCGCAT -> GATACCGCATA
GATACCGCATA -> ATACCGCATAG
ATACCGCATAG -> TACCGCATAGT
TACCGCATAGT -> ACCGCATAGTG
ACCGCATAGTG -> CCGCATAGTGG
CCGCATAGTGG -> CGCATAGTGGC
CGCATAGTGGC -> GCATAGTGGCG
GCATAGTGGCG -> CATAGTGGCGG
CATAGTGGCGG -> ATAGTGGCGGA
ATAGTGGCGGA -> TAGTGGCGGAC
TAGTGGCGGAC -> AGTGGCGGACC
AGTGGCGGACC -> GTGGCGGACCT
GTGGCGGACCT -> TGGCGGACCTT
TGGCGGACCTT -> GGCGGACCTTG
GGCGGACCTTG -> GCGGACCTTGC
GCGGACCTTGC -> CGGACCTTGCG
CGGACCTTGCG -> GGACCTTGCGA
GGACCTTGCGA -> GACCTTGCGAT
GACCTTGCGAT -> ACCTTGCGATG
ACCTTGCGATG -> CCTTGCGATGC
CCTTGCGATGC -> CTTGCGATGCC
CTTGCGATGCC -> TTGCGATGCCC
TTGCGATGCCC -> TGCGATGCCCT
TGCGATGCCCT -> GCGATGCCCTG
GCGATGCCCTG -> CGATGCCCTGA
CGATGCCCTGA -> GATGCCCTGAG
GATGCCCTGAG -> ATGCCCTGAGA
ATGCCCTGAGA -> TGCCCTGAGAA
TGCCCTGAGAA -> GCCCTGAGAAA
GCCCTGAGAAA -> CCCTGAGAAAC
CCCTGAGAAAC -> CCTGAGAAACT
CCTGAGAAACT -> CTGAGAAACTT
CTGAGAAACTT -> TGAGAAACTTG
TGAGAAACTTG -> GAGAAACTTGC
GAGAAACTTGC -> AGAAACTTGCG
AGAAACTTGCG -> GAAACTTGCGC
GAAACTTGCGC -> AAACTTGCGCG
AAACTTGCGCG -> AACTTGCGCGC
AACTTGCGCGC -> ACTTGCGCGCC
ACTTGCGCGCC -> CTTGCGCGCCG
CTTGCGCGCCG -> TTGCGCGCCGC
TTGCGCGCCGC -> TGCGCGCCGCA
TGCGCGCCGCA -> GCGCGCCGCAG
GCGCGCCGCAG -> CGCGCCGCAGC
CGCGCCGCAGC -> GCGCCGCAGCT
GCGCCGCAGCT -> CGCCGCAGCTA
CGCCGCAGCTA -> GCCGCAGCTAA
GCCGCAGCTAA -> CCGCAGCTAAC
CCGCAGCTAAC -> CGCAGCTAACT
CGCAGCTAACT -> GCAGCTAACTT
GCAGCTAACTT -> CAGCTAACTTC
CAGCTAACTTC -> AGCTAACTTCG
AGCTAACTTCG -> GCTAACTTCGC
GCTAACTTCGC -> CTAACTTCGCC
CTAACTTCGCC -> TAACTTCGCCA
TAACTTCGCCA -> AACTTCGCCAA
AACTTCGCCAA -> ACTTCGCCAAG
ACTTCGCCAAG -> CTTCGCCAAGG
CTTCGCCAAGG -> TTCGCCAAGGT
TTCGCCAAGGT -> TCGCCAAGGTT
TCGCCAAGGTT -> CGCCAAGGTTT
CGCCAAGGTTT -> GCCAAGGTTTT
GCCAAGGTTTT -> CCAAGGTTTTT
CCAAGGTTTTT -> CAAGGTTTTTG
CAAGGTTTTTG -> AAGGTTTTTGA
AAGGTTTTTGA -> AGGTTTTTGAA
AGGTTTTTGAA -> GGTTTTTGAAA
GGTTTTTGAAA -> GTTTTTGAAAA
GTTTTTGAAAA -> TTTTTGAAAAC
TTTTTGAAAAC -> TTTTGAAAACG
TTTTGAAAACG -> TTTGAAAACGA
TTTGAAAACGA -> TTGAAAACGAA
TTGAAAACGAA -> TGAAAACGAAC
TGAAAACGAAC -> GAAAACGAACG
GAAAACGAACG -> AAAACGAACGC
AAAACGAACGC -> AAACGAACGCG
AAACGAACGCG -> AACGAACGCGG
AACGAACGCGG -> ACGAACGCGGC
ACGAACGCGGC -> CGAACGCGGCT
CGAACGCGGCT -> GAACGCGGCTA
GAACGCGGCTA -> AACGCGGCTAT
AACGCGGCTAT -> ACGCGGCTATT
ACGCGGCTATT -> CGCGGCTATTC
CGCGGCTATTC -> GCGGCTATTCG
GCGGCTATTCG -> CGGCTATTCGT
CGGCTATTCGT -> GGCTATTCGTT
GGCTATTCGTT -> GCTATTCGTTG
GCTATTCGTTG -> CTATTCGTTGT
CTATTCGTTGT -> TATTCGTTGTT
TATTCGTTGTT -> ATTCGTTGTTG
ATTCGTTGTTG -> TTCGTTGTTGA
TTCGTTGTTGA -> TCGTTGTTGAT
TCGTTGTTGAT -> CGTTGTTGATC
CGTTGTTGATC -> GTTGTTGATCG
GTTGTTGATCG -> TTGTTGATCGA
TTGTTGATCGA -> TGTTGATCGAA
TGTTGATCGAA -> GTTGATCGAAT
GTTGATCGAAT -> TTGATCGAATA
TTGATCGAATA -> TGATCGAATAT
TGATCGAATAT -> GATCGAATATT
GATCGAATATT -> ATCGAATATTG
ATCGAATATTG -> TCGAATATTGC
TCGAATATTGC -> CGAATATTGCA
CGAATATTGCA -> GAATATTGCAG
GAATATTGCAG -> AATATTGCAGT
AATATTGCAGT -> ATATTGCAGTA,ATATTGCAGTG
ATATTGCAGTG -> TATTGCAGTGA
TATTGCAGTGA -> ATTGCAGTGAG
ATTGCAGTGAG -> TTGCAGTGAGT
TTGCAGTGAGT -> TGCAGTGAGTA
TGCAGTGAGTA -> GCAGTGAGTAA
GCAGTGAGTAA -> CAGTGAGTAAG
CAGTGAGTAAG -> AGTGAGTAAGT
AGTGAGTAAGT -> GTGAGTAAGTT
GTGAGTAAGTT -> TGAGTAAGTTT
TGAGTAAGTTT -> GAGTAAGTTTC
GAGTAAGTTTC -> AGTAAGTTTCA
AGTAAGTTTCA -> GTAAGTTTCAC
GTAAGTTTCAC -> TAAGTTTCACA
TAAGTTTCACA -> AAGTTTCACAT
AAGTTTCACAT -> AGTTTCACATA
AGTTTCACATA -> GTTTCACATAC
GTTTCACATAC -> TTTCACATACT
TTTCACATACT -> TTCACATACTG
TTCACATACTG -> TCACATACTGG
TCACATACTGG -> CACATACTGGC
CACATACTGGC -> ACATACTGGCG
ACATACTGGCG -> CATACTGGCGC
CATACTGGCGC -> ATACTGGCGCC
ATACTGGCGCC -> TACTGGCGCCT
TACTGGCGCCT -> ACTGGCGCCTT
ACTGGCGCCTT -> CTGGCGCCTTC
CTGGCGCCTTC -> TGGCGCCTTCA
TGGCGCCTTCA -> GGCGCCTTCAC
GGCGCCTTCAC -> GCGCCTTCACT
GCGCCTTCACT -> CGCCTTCACTT
CGCCTTCACTT -> GCCTTCACTTT
GCCTTCACTTT -> CCTTCACTTTC
CCTTCACTTTC -> CTTCACTTTCT
CTTCACTTTCT -> TTCACTTTCTT
TTCACTTTCTT -> TCACTTTCTTA
TCACTTTCTTA -> CACTTTCTTAT
CACTTTCTTAT -> ACTTTCTTATC
ACTTTCTTATC -> CTTTCTTATCC
CTTTCTTATCC -> TTTCTTATCCG
TTTCTTATCCG -> TTCTTATCCGG
TTCTTATCCGG -> TCTTATCCGGC
TCTTATCCGGC -> CTTATCCGGCG
CTTATCCGGCG -> TTATCCGGCGG
TTATCCGGCGG -> TATCCGGCGGA
TATCCGGCGGA -> ATCCGGCGGAT
ATCCGGCGGAT -> TCCGGCGGATA
TCCGGCGGATA -> CCGGCGGATAC
CCGGCGGATAC -> CGGCGGATACG
CGGCGGATACG -> GGCGGATACGC
GGCGGATACGC -> GCGGATACGCT
GCGGATACGCT -> CGGATACGCTT
CGGATACGCTT -> GGATACGCTTT
GGATACGCTTT -> GATACGCTTTT
GATACGCTTTT -> ATACGCTTTTA
ATACGCTTTTA -> TACGCTTTTAG
TACGCTTTTAG -> ACGCTTTTAGA
ACGCTTTTAGA -> CGCTTTTAGAA
CGCTTTTAGAA -> GCTTTTAGAAG
GCTTTTAGAAG -> CTTTTAGAAGC
CTTTTAGAAGC -> TTTTAGAAGCA
TTTTAGAAGCA -> TTTAGAAGCAA
TTTAGAAGCAA -> TTAGAAGCAAT
TTAGAAGCAAT -> TAGAAGCAATC
TAGAAGCAATC -> AGAAGCAATCA
AGAAGCAATCA -> GAAGCAATCAT
GAAGCAATCAT -> AAGCAATCATG
AAGCAATCATG -> AGCAATCATGC
AGCAATCATGC -> GCAATCATGCC
GCAATCATGCC -> CAATCATGCCC
CAATCATGCCC -> AATCATGCCCC
AATCATGCCCC -> ATCATGCCCCC
ATCATGCCCCC -> TCATGCCCCCC
TCATGCCCCCC -> CATGCCCCCCT
CATGCCCCCCT -> ATGCCCCCCTC
ATGCCCCCCTC -> TGCCCCCCTCT
TGCCCCCCTCT -> GCCCCCCTCTT
GCCCCCCTCTT -> CCCCCCTCTTG
CCCCCCTCTTG -> CCCCCTCTTGC
CCCCCTCTTGC -> CCCCTCTTGCT
CCCCTCTTGCT -> CCCTCTTGCTC
CCCTCTTGCTC -> CCTCTTGCTCC
CCTCTTGCTCC -> CTCTTGCTCCC
CTCTTGCTCCC -> TCTTGCTCCCA
TCTTGCTCCCA -> CTTGCTCCCAA
CTTGCTCCCAA -> TTGCTCCCAAA
TTGCTCCCAAA -> TGCTCCCAAAC
TGCTCCCAAAC -> GCTCCCAAACC
GCTCCCAAACC -> CTCCCAAACCA
CTCCCAAACCA -> TCCCAAACCAG
TCCCAAACCAG -> CCCAAACCAGT
CCCAAACCAGT -> CCAAACCAGTG
CCAAACCAGTG -> CAAACCAGTGT
CAAACCAGTGT -> AAACCAGTGTG
AAACCAGTGTG -> AACCAGTGTGA
AACCAGTGTGA -> ACCAGTGTGAC
ACCAGTGTGAC -> CCAGTGTGACC
CCAGTGTGACC -> CAGTGTGACCT
CAGTGTGACCT -> AGTGTGACCTA
AGTGTGACCTA -> GTGTGACCTAC
GTGTGACCTAC -> TGTGACCTACG
TGTGACCTACG -> GTGACCTACGA
GTGACCTACGA -> TGACCTACGAC
TGACCTACGAC -> GACCTACGACT
GACCTACGACT -> ACCTACGACTC
ACCTACGACTC -> CCTACGACTCA
CCTACGACTCA -> CTACGACTCAT
CTACGACTCAT -> TACGACTCATA
TACGACTCATA -> ACGACTCATAA
ACGACTCATAA -> CGACTCATAAG
CGACTCATAAG -> GACTCATAAGG
GACTCATAAGG -> ACTCATAAGGC
ACTCATAAGGC -> CTCATAAGGCC
CTCATAAGGCC -> TCATAAGGCCC
TCATAAGGCCC -> CATAAGGCCCG
CATAAGGCCCG -> ATAAGGCCCGC
ATAAGGCCCGC -> TAAGGCCCGCT
TAAGGCCCGCT -> AAGGCCCGCTA
AAGGCCCGCTA -> AGGCCCGCTAG
AGGCCCGCTAG -> GGCCCGCTAGA
GGCCCGCTAGA -> GCCCGCTAGAC
GCCCGCTAGAC -> CCCGCTAGACC
CCCGCTAGACC -> CCGCTAGACCC
CCGCTAGACCC -> CGCTAGACCCT
CGCTAGACCCT -> GCTAGACCCTT
GCTAGACCCTT -> CTAGACCCTTT
CTAGACCCTTT -> TAGACCCTTTC
TAGACCCTTTC -> AGACCCTTTCG
AGACCCTTTCG -> GACCCTTTCGG
GACCCTTTCGG -> ACCCTTTCGGG
ACCCTTTCGGG -> CCCTTTCGGGC
CCCTTTCGGGC -> CCTTTCGGGCG
CCTTTCGGGCG -> CTTTCGGGCGT
CTTTCGGGCGT -> TTTCGGGCGTC
TTTCGGGCGTC -> TTCGGGCGTCC
TTCGGGCGTCC -> TCGGGCGTCCG
TCGGGCGTCCG -> CGGGCGTCCGG
CGGGCGTCCGG -> GGGCGTCCGGG
GGGCGTCCGGG -> GGCGTCCGGGT
GGCGTCCGGGT -> GCGTCCGGGTA
GCGTCCGGGTA -> CGTCCGGGTAA
CGTCCGGGTAA -> GTCCGGGTAAG
GTCCGGGTAAG -> TCCGGGTAAGA
TCCGGGTAAGA -> CCGGGTAAGAA
CCGGGTAAGAA -> CGGGTAAGAAC
CGGGTAAGAAC -> GGGTAAGAACA
GGGTAAGAACA -> GGTAAGAACAA
GGTAAGAACAA -> GTAAGAACAAC
GTAAGAACAAC -> TAAGAACAACG
TAAGAACAACG -> AAGAACAACGT
AAGAACAACGT -> AGAACAACGTC
AGAACAACGTC -> GAACAACGTCT
GAACAACGTCT -> AACAACGTCTG
AACAACGTCTG -> ACAACGTCTGC
ACAACGTCTGC -> CAACGTCTGCC
CAACGTCTGCC -> AACGTCTGCCT
AACGTCTGCCT -> ACGTCTGCCTC
ACGTCTGCCTC -> CGTCTGCCTCT
CGTCTGCCTCT -> GTCTGCCTCTA
GTCTGCCTCTA -> TCTGCCTCTAG
TCTGCCTCTAG -> CTGCCTCTAGG
CTGCCTCTAGG -> TGCCTCTAGGT
TGCCTCTAGGT -> GCCTCTAGGTG
GCCTCTAGGTG -> CCTCTAGGTGC
CCTCTAGGTGC -> CTCTAGGTGCC
CTCTAGGTGCC -> TCTAGGTGCCC
TCTAGGTGCCC -> CTAGGTGCCCG
CTAGGTGCCCG -> TAGGTGCCCGT
TAGGTGCCCGT -> AGGTGCCCGTA
AGGTGCCCGTA -> GGTGCCCGTAT
GGTGCCCGTAT -> GTGCCCGTATC
GTGCCCGTATC -> TGCCCGTATCT
TGCCCGTATCT -> GCCCGTATCTT
GCCCGTATCTT -> CCCGTATCTTG
CCCGTATCTTG -> CCGTATCTTGA
CCGTATCTTGA -> CGTATCTTGAG
CGTATCTTGAG -> GTATCTTGAGT
GTATCTTGAGT -> TATCTTGAGTA
TATCTTGAGTA -> ATCTTGAGTAA
ATCTTGAGTAA -> TCTTGAGTAAA
TCTTGAGTAAA -> CTTGAGTAAAC
CTTGAGTAAAC -> TTGAGTAAACT
TTGAGTAAACT -> TGAGTAAACTC
TGAGTAAACTC -> GAGTAAACTCT
GAGTAAACTCT -> AGTAAACTCTC
AGTAAACTCTC -> GTAAACTCTCA
GTAAACTCTCA -> TAAACTCTCAG
TAAACTCTCAG -> AAACTCTCAGT
AAACTCTCAGT -> AACTCTCAGTT
AACTCTCAGTT -> ACTCTCAGTTA
ACTCTCAGTTA -> CTCTCAGTTAT
CTCTCAGTTAT -> TCTCAGTTATA
TCTCAGTTATA -> CTCAGTTATAA
CTCAGTTATAA -> TCAGTTATAAG
TCAGTTATAAG -> CAGTTATAAGC
CAGTTATAAGC -> AGTTATAAGCG
AGTTATAAGCG -> GTTATAAGCGA
GTTATAAGCGA -> TTATAAGCGAC
TTATAAGCGAC -> TATAAGCGACG
TATAAGCGACG -> ATAAGCGACGA
ATAAGCGACGA -> TAAGCGACGAT
TAAGCGACGAT -> AAGCGACGATG
AAGCGACGATG -> AGCGACGATGT
AGCGACGATGT -> GCGACGATGTG
GCGACGATGTG -> CGACGATGTGT
CGACGATGTGT -> GACGATGTGTG
GACGATGTGTG -> ACGATGTGTGT
ACGATGTGTGT -> CGATGTGTGTC
CGATGTGTGTC -> GATGTGTGTCT
GATGTGTGTCT -> ATGTGTGTCTC
ATGTGTGTCTC -> TGTGTGTCTCT
TGTGTGTCTCT -> GTGTGTCTCTG
GTGTGTCTCTG -> TGTGTCTCTGA
TGTGTCTCTGA -> GTGTCTCTGAC
GTGTCTCTGAC -> TGTCTCTGACT
TGTCTCTGACT -> GTCTCTGACTT
GTCTCTGACTT -> TCTCTGACTTG
TCTCTGACTTG -> CTCTGACTTGC
CTCTGACTTGC -> TCTGACTTGCA
TCTGACTTGCA -> CTGACTTGCAT
CTGACTTGCAT -> TGACTTGCATA
TGACTTGCATA -> GACTTGCATAT
GACTTGCATAT -> ACTTGCATATC
ACTTGCATATC -> CTTGCATATCC
CTTGCATATCC -> TTGCATATCCT
TTGCATATCCT -> TGCATATCCTT
TGCATATCCTT -> GCATATCCTTC
GCATATCCTTC -> CATATCCTTCA
CATATCCTTCA -> ATATCCTTCAT
ATATCCTTCAT -> TATCCTTCATT
TATCCTTCATT -> ATCCTTCATTT
ATCCTTCATTT -> TCCTTCATTTT
TCCTTCATTTT -> CCTTCATTTTA
CCTTCATTTTA -> CTTCATTTTAT
CTTCATTTTAT -> TTCATTTTATG
TTCATTTTATG -> TCATTTTATGG
TCATTTTATGG -> CATTTTATGGC
CATTTTATGGC -> ATTTTATGGCT
ATTTTATGGCT -> TTTTATGGCTC
TTTTATGGCTC -> TTTATGGCTCG
TTTATGGCTCG -> TTATGGCTCGT
TTATGGCTCGT -> TATGGCTCGTC
TATGGCTCGTC -> ATGGCTCGTCT
ATGGCTCGTCT -> TGGCTCGTCTA
TGGCTCGTCTA -> GGCTCGTCTAG
GGCTCGTCTAG -> GCTCGTCTAGT
GCTCGTCTAGT -> CTCGTCTAGTG
CTCGTCTAGTG -> TCGTCTAGTGT
TCGTCTAGTGT -> CGTCTAGTGTG
CGTCTAGTGTG -> GTCTAGTGTGT
GTCTAGTGTGT -> TCTAGTGTGTT
TCTAGTGTGTT -> CTAGTGTGTTG
CTAGTGTGTTG -> TAGTGTGTTGC
TAGTGTGTTGC -> AGTGTGTTGCA
AGTGTGTTGCA -> GTGTGTTGCAT
GTGTGTTGCAT -> TGTGTTGCATA
TGTGTTGCATA -> GTGTTGCATAC
GTGTTGCATAC -> TGTTGCATACA
TGTTGCATACA -> GTTGCATACAT
GTTGCATACAT -> TTGCATACATG
TTGCATACATG -> TGCATACATGT
TGCATACATGT -> GCATACATGTA
GCATACATGTA -> CATACATGTAC
CATACATGTAC -> ATACATGTACG
ATACATGTACG -> TACATGTACGA
TACATGTACGA -> ACATGTACGAT
ACATGTACGAT -> CATGTACGATT
CATGTACGATT -> ATGTACGATTC
ATGTACGATTC -> TGTACGATTCT
TGTACGATTCT -> GTACGATTCTC
GTACGATTCTC -> TACGATTCTCA
TACGATTCTCA -> ACGATTCTCAT
ACGATTCTCAT -> CGATTCTCATC
CGATTCTCATC -> GATTCTCATCG
GATTCTCATCG -> ATTCTCATCGC
ATTCTCATCGC -> TTCTCATCGCT
TTCTCATCGCT -> TCTCATCGCTG
TCTCATCGCTG -> CTCATCGCTGA
CTCATCGCTGA -> TCATCGCTGAC
TCATCGCTGAC -> CATCGCTGACG
CATCGCTGACG -> ATCGCTGACGA
ATCGCTGACGA -> TCGCTGACGAC
TCGCTGACGAC -> CGCTGACGACC
CGCTGACGACC -> GCTGACGACCA
GCTGACGACCA -> CTGACGACCAG
CTGACGACCAG -> TGACGACCAGT
TGACGACCAGT -> GACGACCAGTG
GACGACCAGTG -> ACGACCAGTGC
ACGACCAGTGC -> CGACCAGTGCA
CGACCAGTGCA -> GACCAGTGCAT
GACCAGTGCAT -> ACCAGTGCATC
ACCAGTGCATC -> CCAGTGCATCG
CCAGTGCATCG -> CAGTGCATCGC
CAGTGCATCGC -> AGTGCATCGCC
AGTGCATCGCC -> GTGCATCGCCG
GTGCATCGCCG -> TGCATCGCCGC
TGCATCGCCGC -> GCATCGCCGCC
GCATCGCCGCC -> CATCGCCGCCT
CATCGCCGCCT -> ATCGCCGCCTA
ATCGCCGCCTA -> TCGCCGCCTAA
TCGCCGCCTAA -> CGCCGCCTAAT
CGCCGCCTAAT -> GCCGCCTAATA
GCCGCCTAATA -> CCGCCTAATAT
CCGCCTAATAT -> CGCCTAATATT
CGCCTAATATT -> GCCTAATATTG
GCCTAATATTG -> CCTAATATTGC
CCTAATATTGC -> CTAATATTGCA
CTAATATTGCA -> TAATATTGCAG
TAATATTGCAG -> AATATTGCAGT
ATATTGCAGTA -> TATTGCAGTAG
TATTGCAGTAG -> ATTGCAGTAGG
ATTGCAGTAGG -> TTGCAGTAGGT
TTGCAGTAGGT -> TGCAGTAGGTC
TGCAGTAGGTC -> GCAGTAGGTCC
GCAGTAGGTCC -> CAGTAGGTCCC
CAGTAGGTCCC -> AGTAGGTCCCT
AGTAGGTCCCT -> GTAGGTCCCTA
GTAGGTCCCTA -> TAGGTCCCTAT
TAGGTCCCTAT -> AGGTCCCTATT
AGGTCCCTATT -> GGTCCCTATTG
GGTCCCTATTG -> GTCCCTATTGA
GTCCCTATTGA -> TCCCTATTGAT
TCCCTATTGAT -> CCCTATTGATT
CCCTATTGATT -> CCTATTGATTC
CCTATTGATTC -> CTATTGATTCC
CTATTGATTCC -> TATTGATTCCA
TATTGATTCCA -> ATTGATTCCAT
ATTGATTCCAT -> TTGATTCCATT
TTGATTCCATT -> TGATTCCATTG
TGATTCCATTG -> GATTCCATTGT
GATTCCATTGT -> ATTCCATTGTC
ATTCCATTGTC -> TTCCATTGTCT
TTCCATTGTCT -> TCCATTGTCTG
TCCATTGTCTG -> CCATTGTCTGA
CCATTGTCTGA -> CATTGTCTGAT
CATTGTCTGAT -> ATTGTCTGATG
ATTGTCTGATG -> TTGTCTGATGT
TTGTCTGATGT -> TGTCTGATGTC
TGTCTGATGTC -> GTCTGATGTCT
GTCTGATGTCT -> TCTGATGTCTC
TCTGATGTCTC -> CTGATGTCTCT
CTGATGTCTCT -> TGATGTCTCTG
TGATGTCTCTG -> GATGTCTCTGG
GATGTCTCTGG -> ATGTCTCTGGG
ATGTCTCTGGG -> TGTCTCTGGGC
TGTCTCTGGGC -> GTCTCTGGGCA
GTCTCTGGGCA -> TCTCTGGGCAC
TCTCTGGGCAC -> CTCTGGGCACC
CTCTGGGCACC -> TCTGGGCACCT
TCTGGGCACCT -> CTGGGCACCTC
CTGGGCACCTC -> TGGGCACCTCG
TGGGCACCTCG -> GGGCACCTCGT
GGGCACCTCGT -> GGCACCTCGTA
GGCACCTCGTA -> GCACCTCGTAC
GCACCTCGTAC -> CACCTCGTACT
CACCTCGTACT -> ACCTCGTACTT
ACCTCGTACTT -> CCTCGTACTTT
CCTCGTACTTT -> CTCGTACTTTT
CTCGTACTTTT -> TCGTACTTTTC
TCGTACTTTTC -> CGTACTTTTCG
CGTACTTTTCG -> GTACTTTTCGA
GTACTTTTCGA -> TACTTTTCGAA
TACTTTTCGAA -> ACTTTTCGAAC
ACTTTTCGAAC -> CTTTTCGAACC
CTTTTCGAACC -> TTTTCGAACCA
TTTTCGAACCA -> TTTCGAACCAC
TTTCGAACCAC -> TTCGAACCACC
TTCGAACCACC -> TCGAACCACCA
TCGAACCACCA -> CGAACCACCAA
CGAACCACCAA -> GAACCACCAAA
GAACCACCAAA -> AACCACCAAAA
AACCACCAAAA -> ACCACCAAAAT
ACCACCAAAAT -> CCACCAAAATG
CCACCAAAATG -> CACCAAAATGG
CACCAAAATGG -> ACCAAAATGGA
ACCAAAATGGA -> CCAAAATGGAA
CCAAAATGGAA -> CAAAATGGAAC
CAAAATGGAAC -> AAAATGGAACG
AAAATGGAACG -> AAATGGAACGG
AAATGGAACGG -> AATGGAACGGT
AATGGAACGGT -> ATGGAACGGTG
ATGGAACGGTG -> TGGAACGGTGT
TGGAACGGTGT -> GGAACGGTGTA
GGAACGGTGTA -> GAACGGTGTAT
GAACGGTGTAT -> AACGGTGTATC
AACGGTGTATC -> ACGGTGTATCA
ACGGTGTATCA -> CGGTGTATCAC
CGGTGTATCAC -> GGTGTATCACA
GGTGTATCACA -> GTGTATCACAT
GTGTATCACAT -> TGTATCACATG
TGTATCACATG -> GTATCACATGC
GTATCACATGC -> TATCACATGCT
TATCACATGCT -> ATCACATGCTG
ATCACATGCTG -> TCACATGCTGG
TCACATGCTGG -> CACATGCTGGT
CACATGCTGGT -> ACATGCTGGTA
ACATGCTGGTA -> CATGCTGGTAG
CATGCTGGTAG -> ATGCTGGTAGC
ATGCTGGTAGC -> TGCTGGTAGCG
TGCTGGTAGCG -> GCTGGTAGCGG
GCTGGTAGCGG -> CTGGTAGCGGA
CTGGTAGCGGA -> TGGTAGCGGAA
TGGTAGCGGAA -> GGTAGCGGAAC
GGTAGCGGAAC -> GTAGCGGAACG
GTAGCGGAACG -> TAGCGGAACGG
TAGCGGAACGG -> AGCGGAACGGC
AGCGGAACGGC -> GCGGAACGGCT
GCGGAACGGCT -> CGGAACGGCTT
CGGAACGGCTT -> GGAACGGCTTA
GGAACGGCTTA -> GAACGGCTTAC
GAACGGCTTAC -> AACGGCTTACC
AACGGCTTACC -> ACGGCTTACCC
ACGGCTTACCC -> CGGCTTACCCT
CGGCTTACCCT -> GGCTTACCCTT
GGCTTACCCTT -> GCTTACCCTTA
GCTTACCCTTA -> CTTACCCTTAT
CTTACCCTTAT -> TTACCCTTATG
TTACCCTTATG -> TACCCTTATGC
TACCCTTATGC -> ACCCTTATGCT
ACCCTTATGCT -> CCCTTATGCTA
CCCTTATGCTA -> CCTTATGCTAC
CCTTATGCTAC -> CTTATGCTACG
CTTATGCTACG -> TTATGCTACGC
TTATGCTACGC -> TATGCTACGCG
TATGCTACGCG -> ATGCTACGCGC
ATGCTACGCGC -> TGCTACGCGCC
TGCTACGCGCC -> GCTACGCGCCT
GCTACGCGCCT -> CTACGCGCCTG
CTACGCGCCTG -> TACGCGCCTGC
TACGCGCCTGC -> ACGCGCCTGCT
ACGCGCCTGCT -> CGCGCCTGCTC
CGCGCCTGCTC -> GCGCCTGCTCC
GCGCCTGCTCC -> CGCCTGCTCCA
CGCCTGCTCCA -> GCCTGCTCCAT
GCCTGCTCCAT -> CCTGCTCCATG
CCTGCTCCATG -> CTGCTCCATGA
CTGCTCCATGA -> TGCTCCATGAT
TGCTCCATGAT -> GCTCCATGATT
GCTCCATGATT -> CTCCATGATTC
CTCCATGATTC -> TCCATGATTCG
TCCATGATTCG -> CCATGATTCGT
CCATGATTCGT -> CATGATTCGTT
CATGATTCGTT -> ATGATTCGTTG
ATGATTCGTTG -> TGATTCGTTGT
TGATTCGTTGT -> GATTCGTTGTA
GATTCGTTGTA -> ATTCGTTGTAA
ATTCGTTGTAA -> TTCGTTGTAAA
TTCGTTGTAAA -> TCGTTGTAAAT
TCGTTGTAAAT -> CGTTGTAAATC
CGTTGTAAATC -> GTTGTAAATCA
GTTGTAAATCA -> TTGTAAATCAA
TTGTAAATCAA -> TGTAAATCAAT
TGTAAATCAAT -> GTAAATCAATC
GTAAATCAATC -> TAAATCAATCA
TAAATCAATCA -> AAATCAATCAT
AAATCAATCAT -> AATCAATCATG
AATCAATCATG -> ATCAATCATGA
ATCAATCATGA -> TCAATCATGAA
TCAATCATGAA -> CAATCATGAAC
CAATCATGAAC -> AATCATGAACC
AATCATGAACC -> ATCATGAACCG
ATCATGAACCG -> TCATGAACCGT
TCATGAACCGT -> CATGAACCGTC
CATGAACCGTC -> ATGAACCGTCT
ATGAACCGTCT -> TGAACCGTCTT
TGAACCGTCTT -> GAACCGTCTTA
GAACCGTCTTA -> AACCGTCTTAC
AACCGTCTTAC -> ACCGTCTTACC
ACCGTCTTACC -> CCGTCTTACCA
CCGTCTTACCA -> CGTCTTACCAT
CGTCTTACCAT -> GTCTTACCATA
GTCTTACCATA -> TCTTACCATAC
TCTTACCATAC -> CTTACCATACA
CTTACCATACA -> TTACCATACAT
TTACCATACAT -> TACCATACATG
TACCATACATG -> ACCATACATGG
ACCATACATGG -> CCATACATGGC
CCATACATGGC -> CATACATGGCT
CATACATGGCT -> ATACATGGCTA
ATACATGGCTA -> TACATGGCTAG
TACATGGCTAG -> ACATGGCTAGG
ACATGGCTAGG -> CATGGCTAGGT
CATGGCTAGGT -> ATGGCTAGGTC
ATGGCTAGGTC -> TGGCTAGGTCT
TGGCTAGGTCT -> GGCTAGGTCTC
GGCTAGGTCTC -> GCTAGGTCTCA
GCTAGGTCTCA -> CTAGGTCTCAG
CTAGGTCTCAG -> TAGGTCTCAGT
TAGGTCTCAGT -> AGGTCTCAGTA
AGGTCTCAGTA -> GGTCTCAGTAC
GGTCTCAGTAC -> GTCTCAGTACT
GTCTCAGTACT -> TCTCAGTACTT
TCTCAGTACTT -> CTCAGTACTTC
CTCAGTACTTC -> TCAGTACTTCT
TCAGTACTTCT -> CAGTACTTCTC
CAGTACTTCTC -> AGTACTTCTCC
AGTACTTCTCC -> GTACTTCTCCC
GTACTTCTCCC -> TACTTCTCCCT
TACTTCTCCCT -> ACTTCTCCCTT
ACTTCTCCCTT -> CTTCTCCCTTT
CTTCTCCCTTT -> TTCTCCCTTTG
TTCTCCCTTTG -> TCTCCCTTTGT
TCTCCCTTTGT -> CTCCCTTTGTT
CTCCCTTTGTT -> TCCCTTTGTTA
TCCCTTTGTTA -> CCCTTTGTTAC
CCCTTTGTTAC -> CCTTTGTTACG
CCTTTGTTACG -> CTTTGTTACGG
CTTTGTTACGG -> TTTGTTACGGG
TTTGTTACGGG -> TTGTTACGGGA
TTGTTACGGGA -> TGTTACGGGAA
TGTTACGGGAA -> GTTACGGGAAT
GTTACGGGAAT -> TTACGGGAATC
TTACGGGAATC -> TACGGGAATCA
TACGGGAATCA -> ACGGGAATCAA
ACGGGAATCAA -> CGGGAATCAAT
CGGGAATCAAT -> GGGAATCAATA
GGGAATCAATA -> GGAATCAATAT
GGAATCAATAT -> GAATCAATATC
GAATCAATATC -> AATCAATATCT
AATCAATATCT -> ATCAATATCTT
ATCAATATCTT -> TCAATATCTTT
TCAATATCTTT -> CAATATCTTTT
CAATATCTTTT -> AATATCTTTTA
AATATCTTTTA -> ATATCTTTTAT
ATATCTTTTAT -> TATCTTTTATG
TATCTTTTATG -> ATCTTTTATGG
ATCTTTTATGG -> TCTTTTATGGT
TCTTTTATGGT -> CTTTTATGGTT
CTTTTATGGTT -> TTTTATGGTTG
TTTTATGGTTG -> TTTATGGTTGT
TTTATGGTTGT -> TTATGGTTGTC
TTATGGTTGTC -> TATGGTTGTCC
TATGGTTGTCC -> ATGGTTGTCCG
ATGGTTGTCCG -> TGGTTGTCCGA
TGGTTGTCCGA -> GGTTGTCCGAA
GGTTGTCCGAA -> GTTGTCCGAAA
GTTGTCCGAAA -> TTGTCCGAAAC
TTGTCCGAAAC -> TGTCCGAAACG
TGTCCGAAACG -> GTCCGAAACGC
GTCCGAAACGC -> TCCGAAACGCT
TCCGAAACGCT -> CCGAAACGCTC
CCGAAACGCTC -> CGAAACGCTCA
CGAAACGCTCA -> GAAACGCTCAT
GAAACGCTCAT -> AAACGCTCATC
AAACGCTCATC -> AACGCTCATCT
AACGCTCATCT -> ACGCTCATCTC
ACGCTCATCTC -> CGCTCATCTCG
CGCTCATCTCG -> GCTCATCTCGG
GCTCATCTCGG -> CTCATCTCGGT
CTCATCTCGGT -> TCATCTCGGTA
TCATCTCGGTA -> CATCTCGGTAT
CATCTCGGTAT -> ATCTCGGTATC
ATCTCGGTATC -> TCTCGGTATCA
TCTCGGTATCA -> CTCGGTATCAG
CTCGGTATCAG -> TCGGTATCAGG
TCGGTATCAGG -> CGGTATCAGGT
CGGTATCAGGT -> GGTATCAGGTC
GGTATCAGGTC -> GTATCAGGTCA
GTATCAGGTCA -> TATCAGGTCAC
TATCAGGTCAC -> ATCAGGTCACT
ATCAGGTCACT -> TCAGGTCACTA
TCAGGTCACTA -> CAGGTCACTAT
CAGGTCACTAT -> AGGTCACTATG
AGGTCACTATG -> GGTCACTATGG
GGTCACTATGG -> GTCACTATGGA
GTCACTATGGA -> TCACTATGGAC
TCACTATGGAC -> CACTATGGACA
CACTATGGACA -> ACTATGGACAG
ACTATGGACAG -> CTATGGACAGT
CTATGGACAGT -> TATGGACAGTC
TATGGACAGTC -> ATGGACAGTCC
ATGGACAGTCC -> TGGACAGTCCC
TGGACAGTCCC -> GGACAGTCCCC
GGACAGTCCCC -> GACAGTCCCCC
GACAGTCCCCC -> ACAGTCCCCCT
ACAGTCCCCCT -> CAGTCCCCCTG
CAGTCCCCCTG -> AGTCCCCCTGT
AGTCCCCCTGT -> GTCCCCCTGTG
GTCCCCCTGTG -> TCCCCCTGTGC
TCCCCCTGTGC -> CCCCCTGTGCA
CCCCCTGTGCA -> CCCCTGTGCAA
CCCCTGTGCAA -> CCCTGTGCAAG
CCCTGTGCAAG -> CCTGTGCAAGA
CCTGTGCAAGA -> CTGTGCAAGAA
CTGTGCAAGAA -> TGTGCAAGAAT
TGTGCAAGAAT -> GTGCAAGAATT
GTGCAAGAATT -> TGCAAGAATTT
TGCAAGAATTT -> GCAAGAATTTA
GCAAGAATTTA -> CAAGAATTTAT
CAAGAATTTAT -> AAGAATTTATC
AAGAATTTATC -> AGAATTTATCC
AGAATTTATCC -> GAATTTATCCT
GAATTTATCCT -> AATTTATCCTA
AATTTATCCTA -> ATTTATCCTAT
ATTTATCCTAT -> TTTATCCTATC
TTTATCCTATC -> TTATCCTATCG
TTATCCTATCG -> TATCCTATCGA
TATCCTATCGA -> ATCCTATCGAT
ATCCTATCGAT -> TCCTATCGATT
TCCTATCGATT -> CCTATCGATTT
CCTATCGATTT -> CTATCGATTTA
CTATCGATTTA -> TATCGATTTAT
TATCGATTTAT -> ATCGATTTATC
ATCGATTTATC -> TCGATTTATCT
TCGATTTATCT -> CGATTTATCTT
CGATTTATCTT -> GATTTATCTTC
GATTTATCTTC -> ATTTATCTTCA
ATTTATCTTCA -> TTTATCTTCAG
TTTATCTTCAG -> TTATCTTCAGC
TTATCTTCAGC -> TATCTTCAGCG
TATCTTCAGCG -> ATCTTCAGCGA
ATCTTCAGCGA -> TCTTCAGCGAT
TCTTCAGCGAT -> CTTCAGCGATC
CTTCAGCGATC -> TTCAGCGATCA
TTCAGCGATCA -> TCAGCGATCAA
TCAGCGATCAA -> CAGCGATCAAG
CAGCGATCAAG -> AGCGATCAAGG
AGCGATCAAGG -> GCGATCAAGGC
GCGATCAAGGC -> CGATCAAGGCC
CGATCAAGGCC -> GATCAAGGCCC
GATCAAGGCCC -> ATCAAGGCCCA
ATCAAGGCCCA -> TCAAGGCCCAC
TCAAGGCCCAC -> CAAGGCCCACA
CAAGGCCCACA -> AAGGCCCACAA
AAGGCCCACAA -> AGGCCCACAAC
AGGCCCACAAC -> GGCCCACAACC
GGCCCACAACC -> GCCCACAACCT
GCCCACAACCT -> CCCACAACCTA
CCCACAACCTA -> CCACAACCTAG
CCACAACCTAG -> CACAACCTAGC
CACAACCTAGC -> ACAACCTAGCC
ACAACCTAGCC -> CAACCTAGCCG
CAACCTAGCCG -> AACCTAGCCGT
AACCTAGCCGT -> ACCTAGCCGTA
ACCTAGCCGTA -> CCTAGCCGTAC
CCTAGCCGTAC -> CTAGCCGTACA
CTAGCCGTACA -> TAGCCGTACAA
TAGCCGTACAA -> AGCCGTACAAC
AGCCGTACAAC -> GCCGTACAACA
GCCGTACAACA -> CCGTACAACAT
CCGTACAACAT -> CGTACAACATC
CGTACAACATC -> GTACAACATCT
GTACAACATCT -> TACAACATCTT
TACAACATCTT -> ACAACATCTTT
ACAACATCTTT -> CAACATCTTTA
CAACATCTTTA -> AACATCTTTAT
AACATCTTTAT -> ACATCTTTATA
ACATCTTTATA -> CATCTTTATAA
CATCTTTATAA -> ATCTTTATAAT
ATCTTTATAAT -> TCTTTATAATT
TCTTTATAATT -> CTTTATAATTC
CTTTATAATTC -> TTTATAATTCT
TTTATAATTCT -> TTATAATTCTG
TTATAATTCTG -> TATAATTCTGT
TATAATTCTGT -> ATAATTCTGTA
ATAATTCTGTA -> TAATTCTGTAG
TAATTCTGTAG -> AATTCTGTAGA
AATTCTGTAGA -> ATTCTGTAGAG
ATTCTGTAGAG -> TTCTGTAGAGC
TTCTGTAGAGC -> TCTGTAGAGCT
TCTGTAGAGCT -> CTGTAGAGCTC
CTGTAGAGCTC -> TGTAGAGCTCT
TGTAGAGCTCT -> GTAGAGCTCTT
GTAGAGCTCTT -> TAGAGCTCTTC
TAGAGCTCTTC -> AGAGCTCTTCC
AGAGCTCTTCC -> GAGCTCTTCCA
GAGCTCTTCCA -> AGCTCTTCCAG
AGCTCTTCCAG -> GCTCTTCCAGT
GCTCTTCCAGT -> CTCTTCCAGTT
CTCTTCCAGTT -> TCTTCCAGTTC
TCTTCCAGTTC -> CTTCCAGTTCA
CTTCCAGTTCA -> TTCCAGTTCAC
TTCCAGTTCAC -> TCCAGTTCACT
TCCAGTTCACT -> CCAGTTCACTC
CCAGTTCACTC -> CAGTTCACTCG
CAGTTCACTCG -> AGTTCACTCGG
AGTTCACTCGG -> GTTCACTCGGT
GTTCACTCGGT -> TTCACTCGGTC
TTCACTCGGTC -> TCACTCGGTCG
TCACTCGGTCG -> CACTCGGTCGA
CACTCGGTCGA -> ACTCGGTCGAG
ACTCGGTCGAG -> CTCGGTCGAGT
CTCGGTCGAGT -> TCGGTCGAGTC
TCGGTCGAGTC -> CGGTCGAGTCC
CGGTCGAGTCC -> GGTCGAGTCCA
GGTCGAGTCCA -> GTCGAGTCCAG
GTCGAGTCCAG -> TCGAGTCCAGG
TCGAGTCCAGG -> CGAGTCCAGGT
CGAGTCCAGGT -> GAGTCCAGGTT
GAGTCCAGGTT -> AGTCCAGGTTA
AGTCCAGGTTA -> GTCCAGGTTAC
GTCCAGGTTAC -> TCCAGGTTACA
TCCAGGTTACA -> CCAGGTTACAT
CCAGGTTACAT -> CAGGTTACATG
CAGGTTACATG -> AGGTTACATGG
AGGTTACATGG -> GGTTACATGGG
GGTTACATGGG -> GTTACATGGGT
GTTACATGGGT -> TTACATGGGTT
TTACATGGGTT -> TACATGGGTTT
TACATGGGTTT -> ACATGGGTTTT
ACATGGGTTTT -> CATGGGTTTTA
CATGGGTTTTA -> ATGGGTTTTAA
ATGGGTTTTAA -> TGGGTTTTAAC
TGGGTTTTAAC -> GGGTTTTAACC
GGGTTTTAACC -> GGTTTTAACCA
GGTTTTAACCA -> GTTTTAACCAA
GTTTTAACCAA -> TTTTAACCAAT
TTTTAACCAAT -> TTTAACCAATA
TTTAACCAATA -> TTAACCAATAC
TTAACCAATAC -> TAACCAATACG
TAACCAATACG -> AACCAATACGG
AACCAATACGG -> ACCAATACGGG
ACCAATACGGG -> CCAATACGGGT
CCAATACGGGT -> CAATACGGGTA
CAATACGGGTA -> AATACGGGTAT
AATACGGGTAT -> ATACGGGTATT
ATACGGGTATT -> TACGGGTATTG
TACGGGTATTG -> ACGGGTATTGA
ACGGGTATTGA -> CGGGTATTGAG
CGGGTATTGAG -> GGGTATTGAGT
GGGTATTGAGT -> GGTATTGAGTC
GGTATTGAGTC -> GTATTGAGTCG
GTATTGAGTCG -> TATTGAGTCGA
TATTGAGTCGA -> ATTGAGTCGAG
ATTGAGTCGAG -> TTGAGTCGAGT
TTGAGTCGAGT -> TGAGTCGAGTG
TGAGTCGAGTG -> GAGTCGAGTGC
GAGTCGAGTGC -> AGTCGAGTGCG
AGTCGAGTGCG -> GTCGAGTGCGC
GTCGAGTGCGC -> TCGAGTGCGCT
TCGAGTGCGCT -> CGAGTGCGCTC
CGAGTGCGCTC -> GAGTGCGCTCT
GAGTGCGCTCT -> AGTGCGCTCTC
AGTGCGCTCTC -> GTGCGCTCTCT
GTGCGCTCTCT -> TGCGCTCTCTC
TGCGCTCTCTC -> GCGCTCTCTCT
GCGCTCTCTCT -> CGCTCTCTCTT
CGCTCTCTCTT -> GCTCTCTCTTG
GCTCTCTCTTG -> CTCTCTCTTGA
CTCTCTCTTGA -> TCTCTCTTGAT
TCTCTCTTGAT -> CTCTCTTGATG
CTCTCTTGATG -> TCTCTTGATGT
TCTCTTGATGT -> CTCTTGATGTG
CTCTTGATGTG -> TCTTGATGTGA
TCTTGATGTGA -> CTTGATGTGAC
CTTGATGTGAC -> TTGATGTGACC
TTGATGTGACC -> TGATGTGACCG
TGATGTGACCG -> GATGTGACCGA
GATGTGACCGA -> ATGTGACCGAG
ATGTGACCGAG -> TGTGACCGAGT
TGTGACCGAGT -> GTGACCGAGTG
GTGACCGAGTG -> TGACCGAGTGC
TGACCGAGTGC -> GACCGAGTGCA
GACCGAGTGCA -> ACCGAGTGCAC
ACCGAGTGCAC -> CCGAGTGCACT
CCGAGTGCACT -> CGAGTGCACTA
CGAGTGCACTA -> GAGTGCACTAA
GAGTGCACTAA -> AGTGCACTAAT
AGTGCACTAAT -> GTGCACTAATA
GTGCACTAATA -> TGCACTAATAG
TGCACTAATAG -> GCACTAATAGC
GCACTAATAGC -> CACTAATAGCT
CACTAATAGCT -> ACTAATAGCTT
ACTAATAGCTT -> CTAATAGCTTT
CTAATAGCTTT -> TAATAGCTTTG
TAATAGCTTTG -> AATAGCTTTGC
AATAGCTTTGC -> ATAGCTTTGCC
ATAGCTTTGCC -> TAGCTTTGCCC
TAGCTTTGCCC -> AGCTTTGCCCC
AGCTTTGCCCC -> GCTTTGCCCCG
GCTTTGCCCCG -> CTTTGCCCCGG
CTTTGCCCCGG -> TTTGCCCCGGA
TTTGCCCCGGA -> TTGCCCCGGAA
TTGCCCCGGAA -> TGCCCCGGAAT
TGCCCCGGAAT -> GCCCCGGAATC
GCCCCGGAATC -> CCCCGGAATCT
CCCCGGAATCT -> CCCGGAATCTA
CCCGGAATCTA -> CCGGAATCTAT
CCGGAATCTAT -> CGGAATCTATA
CGGAATCTATA -> GGAATCTATAC
GGAATCTATAC -> GAATCTATACC
GAATCTATACC -> AATCTATACCA
AATCTATACCA -> ATCTATACCAA
ATCTATACCAA -> TCTATACCAAT
TCTATACCAAT -> CTATACCAATA
CTATACCAATA -> TATACCAATAT
TATACCAATAT -> ATACCAATATG
ATACCAATATG -> TACCAATATGA
TACCAATATGA -> ACCAATATGAT
ACCAATATGAT -> CCAATATGATT
CCAATATGATT -> CAATATGATTA
CAATATGATTA -> AATATGATTAC
AATATGATTAC -> ATATGATTACG
ATATGATTACG -> TATGATTACGC
TATGATTACGC -> ATGATTACGCA
ATGATTACGCA -> TGATTACGCAT
TGATTACGCAT -> GATTACGCATA
GATTACGCATA -> ATTACGCATAT
ATTACGCATAT -> TTACGCATATT
TTACGCATATT -> TACGCATATTG
TACGCATATTG -> ACGCATATTGA
ACGCATATTGA -> CGCATATTGAC
CGCATATTGAC -> GCATATTGACC
GCATATTGACC -> CATATTGACCT
CATATTGACCT -> ATATTGACCTG
ATATTGACCTG -> TATTGACCTGC
TATTGACCTGC -> ATTGACCTGCC
ATTGACCTGCC -> TTGACCTGCCA
TTGACCTGCCA -> TGACCTGCCAC
TGACCTGCCAC -> GACCTGCCACG
GACCTGCCACG -> ACCTGCCACGC
ACCTGCCACGC -> CCTGCCACGCT
CCTGCCACGCT -> CTGCCACGCTG
CTGCCACGCTG -> TGCCACGCTGC
TGCCACGCTGC -> GCCACGCTGCA
GCCACGCTGCA -> CCACGCTGCAC
CCACGCTGCAC -> CACGCTGCACA
CACGCTGCACA -> ACGCTGCACAA
ACGCTGCACAA -> CGCTGCACAAG
CGCTGCACAAG -> GCTGCACAAGC
GCTGCACAAGC -> CTGCACAAGCC
CTGCACAAGCC -> TGCACAAGCCC
TGCACAAGCCC -> GCACAAGCCCA
GCACAAGCCCA -> CACAAGCCCAC
CACAAGCCCAC -> ACAAGCCCACT
ACAAGCCCACT -> CAAGCCCACTG
CAAGCCCACTG -> AAGCCCACTGC
AAGCCCACTGC -> AGCCCACTGCG
AGCCCACTGCG -> GCCCACTGCGA
GCCCACTGCGA -> CCCACTGCGAG
CCCACTGCGAG -> CCACTGCGAGA
CCACTGCGAGA -> CACTGCGAGAA
CACTGCGAGAA -> ACTGCGAGAAT
ACTGCGAGAAT -> CTGCGAGAATG
CTGCGAGAATG -> TGCGAGAATGC
TGCGAGAATGC -> GCGAGAATGCA
GCGAGAATGCA -> CGAGAATGCAG
CGAGAATGCAG -> GAGAATGCAGA
GAGAATGCAGA -> AGAATGCAGAC
AGAATGCAGAC -> GAATGCAGACA
GAATGCAGACA -> AATGCAGACAG
AATGCAGACAG -> ATGCAGACAGT
ATGCAGACAGT -> TGCAGACAGTA
TGCAGACAGTA -> GCAGACAGTAG
GCAGACAGTAG -> CAGACAGTAGG
CAGACAGTAGG -> AGACAGTAGGC
AGACAGTAGGC -> GACAGTAGGCC
GACAGTAGGCC -> ACAGTAGGCCG
ACAGTAGGCCG -> CAGTAGGCCGC
CAGTAGGCCGC -> AGTAGGCCGCG
AGTAGGCCGCG -> GTAGGCCGCGG
GTAGGCCGCGG -> TAGGCCGCGGC
TAGGCCGCGGC -> AGGCCGCGGCA
AGGCCGCGGCA -> GGCCGCGGCAC
GGCCGCGGCAC -> GCCGCGGCACA
GCCGCGGCACA -> CCGCGGCACAT
CCGCGGCACAT -> CGCGGCACATA
CGCGGCACATA -> GCGGCACATAG
GCGGCACATAG -> CGGCACATAGG
CGGCACATAGG -> GGCACATAGGT
GGCACATAGGT -> GCACATAGGTC
GCACATAGGTC -> CACATAGGTCG
CACATAGGTCG -> ACATAGGTCGT
ACATAGGTCGT -> CATAGGTCGTT
CATAGGTCGTT -> ATAGGTCGTTT
ATAGGTCGTTT -> TAGGTCGTTTA
TAGGTCGTTTA -> AGGTCGTTTAA
AGGTCGTTTAA -> GGTCGTTTAAT
GGTCGTTTAAT -> GTCGTTTAATT
GTCGTTTAATT -> TCGTTTAATTC
TCGTTTAATTC -> CGTTTAATTCC
CGTTTAATTCC -> GTTTAATTCCA
GTTTAATTCCA -> TTTAATTCCAA
TTTAATTCCAA -> TTAATTCCAAC
TTAATTCCAAC -> TAATTCCAACC
TAATTCCAACC -> AATTCCAACCG
AATTCCAACCG -> ATTCCAACCGG
ATTCCAACCGG -> TTCCAACCGGG
TTCCAACCGGG -> TCCAACCGGGA
TCCAACCGGGA -> CCAACCGGGAA
CCAACCGGGAA -> CAACCGGGAAG
CAACCGGGAAG -> AACCGGGAAGA
AACCGGGAAGA -> ACCGGGAAGAT
ACCGGGAAGAT -> CCGGGAAGATC
CCGGGAAGATC -> CGGGAAGATCC
CGGGAAGATCC -> GGGAAGATCCG
GGGAAGATCCG -> GGAAGATCCGG
GGAAGATCCGG -> GAAGATCCGGG
GAAGATCCGGG -> AAGATCCGGGC
AAGATCCGGGC -> AGATCCGGGCC
AGATCCGGGCC -> GATCCGGGCCC
GATCCGGGCCC -> ATCCGGGCCCC
ATCCGGGCCCC -> TCCGGGCCCCT
TCCGGGCCCCT -> CCGGGCCCCTG
CCGGGCCCCTG -> CGGGCCCCTGA
CGGGCCCCTGA -> GGGCCCCTGAT
GGGCCCCTGAT -> GGCCCCTGATC
GGCCCCTGATC -> GCCCCTGATCG
GCCCCTGATCG -> CCCCTGATCGG
CCCCTGATCGG -> CCCTGATCGGT
CCCTGATCGGT -> CCTGATCGGTT
CCTGATCGGTT -> CTGATCGGTTA
CTGATCGGTTA -> TGATCGGTTAA
TGATCGGTTAA -> GATCGGTTAAC
GATCGGTTAAC -> ATCGGTTAACA
ATCGGTTAACA -> TCGGTTAACAG
TCGGTTAACAG -> CGGTTAACAGA
CGGTTAACAGA -> GGTTAACAGAA
GGTTAACAGAA -> GTTAACAGAAT
GTTAACAGAAT -> TTAACAGAATC
TTAACAGAATC -> TAACAGAATCC
TAACAGAATCC -> AACAGAATCCC
AACAGAATCCC -> ACAGAATCCCT
ACAGAATCCCT -> CAGAATCCCTG
CAGAATCCCTG -> AGAATCCCTGT
AGAATCCCTGT -> GAATCCCTGTG
GAATCCCTGTG -> AATCCCTGTGA
AATCCCTGTGA -> ATCCCTGTGAA
ATCCCTGTGAA -> TCCCTGTGAAC
TCCCTGTGAAC -> CCCTGTGAACG
CCCTGTGAACG -> CCTGTGAACGC
CCTGTGAACGC -> CTGTGAACGCG
CTGTGAACGCG -> TGTGAACGCGA
TGTGAACGCGA -> GTGAACGCGAT
GTGAACGCGAT -> TGAACGCGATT
TGAACGCGATT -> GAACGCGATTC
GAACGCGATTC -> AACGCGATTCA
AACGCGATTCA -> ACGCGATTCAG
ACGCGATTCAG -> CGCGATTCAGA
CGCGATTCAGA -> GCGATTCAGAA
GCGATTCAGAA -> CGATTCAGAAC
CGATTCAGAAC -> GATTCAGAACG
GATTCAGAACG -> ATTCAGAACGC
ATTCAGAACGC -> TTCAGAACGCG
TTCAGAACGCG -> TCAGAACGCGC
TCAGAACGCGC -> CAGAACGCGCC
CAGAACGCGCC -> AGAACGCGCCC
AGAACGCGCCC -> GAACGCGCCCA
GAACGCGCCCA -> AACGCGCCCAT
AACGCGCCCAT -> ACGCGCCCATT
ACGCGCCCATT -> CGCGCCCATTT
CGCGCCCATTT -> GCGCCCATTTG
GCGCCCATTTG -> CGCCCATTTGT
CGCCCATTTGT -> GCCCATTTGTC
GCCCATTTGTC -> CCCATTTGTCC
CCCATTTGTCC -> CCATTTGTCCC
CCATTTGTCCC -> CATTTGTCCCT
CATTTGTCCCT -> ATTTGTCCCTG
ATTTGTCCCTG -> TTTGTCCCTGA
TTTGTCCCTGA -> TTGTCCCTGAT
TTGTCCCTGAT -> TGTCCCTGATT
TGTCCCTGATT -> GTCCCTGATTA
GTCCCTGATTA -> TCCCTGATTAT
TCCCTGATTAT -> CCCTGATTATT
CCCTGATTATT -> CCTGATTATTT
CCTGATTATTT -> CTGATTATTTA
CTGATTATTTA -> TGATTATTTAC
TGATTATTTAC -> GATTATTTACC
GATTATTTACC -> ATTATTTACCG
ATTATTTACCG -> TTATTTACCGA
TTATTTACCGA -> TATTTACCGAT
TATTTACCGAT -> ATTTACCGATT
ATTTACCGATT -> TTTACCGATTC
TTTACCGATTC -> TTACCGATTCC
TTACCGATTCC -> TACCGATTCCG
TACCGATTCCG -> ACCGATTCCGT
ACCGATTCCGT -> CCGATTCCGTT
CCGATTCCGTT -> CGATTCCGTTG
CGATTCCGTTG -> GATTCCGTTGG
GATTCCGTTGG -> ATTCCGTTGGT
ATTCCGTTGGT -> TTCCGTTGGTT
TTCCGTTGGTT -> TCCGTTGGTTA
TCCGTTGGTTA -> CCGTTGGTTAA
CCGTTGGTTAA -> CGTTGGTTAAG
CGTTGGTTAAG -> GTTGGTTAAGT
GTTGGTTAAGT -> TTGGTTAAGTA
TTGGTTAAGTA -> TGGTTAAGTAA
TGGTTAAGTAA -> GGTTAAGTAAT
GGTTAAGTAAT -> GTTAAGTAATG
GTTAAGTAATG -> TTAAGTAATGG
TTAAGTAATGG -> TAAGTAATGGG
TAAGTAATGGG -> AAGTAATGGGT
AAGTAATGGGT -> AGTAATGGGTC
AGTAATGGGTC -> GTAATGGGTCT
GTAATGGGTCT -> TAATGGGTCTG
TAATGGGTCTG -> AATGGGTCTGC
AATGGGTCTGC -> ATGGGTCTGCA
ATGGGTCTGCA -> TGGGTCTGCAC
TGGGTCTGCAC -> GGGTCTGCACT
GGGTCTGCACT -> GGTCTGCACTC
GGTCTGCACTC -> GTCTGCACTCC
GTCTGCACTCC -> TCTGCACTCCT
TCTGCACTCCT -> CTGCACTCCTT
CTGCACTCCTT -> TGCACTCCTTG
TGCACTCCTTG -> GCACTCCTTGG
GCACTCCTTGG -> CACTCCTTGGC
CACTCCTTGGC -> ACTCCTTGGCG
ACTCCTTGGCG -> CTCCTTGGCGG
CTCCTTGGCGG -> TCCTTGGCGGG
TCCTTGGCGGG -> CCTTGGCGGGG
CCTTGGCGGGG -> CTTGGCGGGGG
CTTGGCGGGGG -> TTGGCGGGGGA
TTGGCGGGGGA -> TGGCGGGGGAT
TGGCGGGGGAT -> GGCGGGGGATC
GGCGGGGGATC -> GCGGGGGATCA
GCGGGGGATCA -> CGGGGGATCAG
CGGGGGATCAG -> GGGGGATCAGC
GGGGGATCAGC -> GGGGATCAGCC
GGGGATCAGCC -> GGGATCAGCCC
GGGATCAGCCC -> GGATCAGCCCG
GGATCAGCCCG -> GATCAGCCCGG
GATCAGCCCGG -> ATCAGCCCGGC
ATCAGCCCGGC -> TCAGCCCGGCT
TCAGCCCGGCT -> CAGCCCGGCTT
CAGCCCGGCTT -> AGCCCGGCTTC
AGCCCGGCTTC -> GCCCGGCTTCG
GCCCGGCTTCG -> CCCGGCTTCGT
CCCGGCTTCGT -> CCGGCTTCGTG
CCGGCTTCGTG -> CGGCTTCGTGC
CGGCTTCGTGC -> GGCTTCGTGCG
GGCTTCGTGCG -> GCTTCGTGCGC
GCTTCGTGCGC -> CTTCGTGCGCC
CTTCGTGCGCC -> TTCGTGCGCCT
TTCGTGCGCCT -> TCGTGCGCCTC
TCGTGCGCCTC -> CGTGCGCCTCT
CGTGCGCCTCT -> GTGCGCCTCTC
GTGCGCCTCTC -> TGCGCCTCTCA
TGCGCCTCTCA -> GCGCCTCTCAC
GCGCCTCTCAC -> CGCCTCTCACC
CGCCTCTCACC -> GCCTCTCACCA
GCCTCTCACCA -> CCTCTCACCAA
CCTCTCACCAA -> CTCTCACCAAC
CTCTCACCAAC -> TCTCACCAACC
TCTCACCAACC -> CTCACCAACCA
CTCACCAACCA -> TCACCAACCAC
TCACCAACCAC -> CACCAACCACC
CACCAACCACC -> ACCAACCACCG
ACCAACCACCG -> CCAACCACCGG
CCAACCACCGG -> CAACCACCGGA
CAACCACCGGA -> AACCACCGGAT
AACCACCGGAT -> ACCACCGGATC
ACCACCGGATC -> CCACCGGATCG
CCACCGGATCG -> CACCGGATCGC
CACCGGATCGC -> ACCGGATCGCC
ACCGGATCGCC -> CCGGATCGCCT
CCGGATCGCCT -> CGGATCGCCTT
CGGATCGCCTT -> GGATCGCCTTC
GGATCGCCTTC -> GATCGCCTTCA
GATCGCCTTCA -> ATCGCCTTCAC
ATCGCCTTCAC -> TCGCCTTCACG
TCGCCTTCACG -> CGCCTTCACGC
CGCCTTCACGC -> GCCTTCACGCT
GCCTTCACGCT -> CCTTCACGCTG
CCTTCACGCTG -> CTTCACGCTGC
CTTCACGCTGC -> TTCACGCTGCT
TTCACGCTGCT -> TCACGCTGCTG
TCACGCTGCTG -> CACGCTGCTGC
CACGCTGCTGC -> ACGCTGCTGCA
ACGCTGCTGCA -> CGCTGCTGCAT
CGCTGCTGCAT -> GCTGCTGCATC
GCTGCTGCATC -> CTGCTGCATCA
CTGCTGCATCA -> TGCTGCATCAT
TGCTGCATCAT -> GCTGCATCATC
GCTGCATCATC -> CTGCATCATCT
CTGCATCATCT -> TGCATCATCTC
TGCATCATCTC -> GCATCATCTCA
GCATCATCTCA -> CATCATCTCAC
CATCATCTCAC -> ATCATCTCACA
ATCATCTCACA -> TCATCTCACAG
TCATCTCACAG -> CATCTCACAGA
CATCTCACAGA -> ATCTCACAGAT
ATCTCACAGAT -> TCTCACAGATC
TCTCACAGATC -> CTCACAGATCC
CTCACAGATCC -> TCACAGATCCT
TCACAGATCCT -> CACAGATCCTC
CACAGATCCTC -> ACAGATCCTCT
ACAGATCCTCT -> CAGATCCTCTA
CAGATCCTCTA -> AGATCCTCTAG
AGATCCTCTAG -> GATCCTCTAGG
GATCCTCTAGG -> ATCCTCTAGGC
ATCCTCTAGGC -> TCCTCTAGGCC
TCCTCTAGGCC -> CCTCTAGGCCA
CCTCTAGGCCA -> CTCTAGGCCAT
CTCTAGGCCAT -> TCTAGGCCATA
TCTAGGCCATA -> CTAGGCCATAG
CTAGGCCATAG -> TAGGCCATAGG
TAGGCCATAGG -> AGGCCATAGGA
AGGCCATAGGA -> GGCCATAGGAT
GGCCATAGGAT -> GCCATAGGATG
GCCATAGGATG -> CCATAGGATGA
CCATAGGATGA -> CATAGGATGAT
CATAGGATGAT -> ATAGGATGATT
ATAGGATGATT -> TAGGATGATTT
TAGGATGATTT -> AGGATGATTTC
AGGATGATTTC -> GGATGATTTCA
GGATGATTTCA -> GATGATTTCAC
GATGATTTCAC -> ATGATTTCACA
ATGATTTCACA -> TGATTTCACAT
TGATTTCACAT -> GATTTCACATT
GATTTCACATT -> ATTTCACATTA
ATTTCACATTA -> TTTCACATTAC
TTTCACATTAC -> TTCACATTACA
TTCACATTACA -> TCACATTACAC
TCACATTACAC -> CACATTACACC
CACATTACACC -> ACATTACACCG
ACATTACACCG -> CATTACACCGA
CATTACACCGA -> ATTACACCGAG
ATTACACCGAG -> TTACACCGAGA
TTACACCGAGA -> TACACCGAGAA
TACACCGAGAA -> ACACCGAGAAC
ACACCGAGAAC -> CACCGAGAACT
CACCGAGAACT -> ACCGAGAACTG
ACCGAGAACTG -> CCGAGAACTGG
CCGAGAACTGG -> CGAGAACTGGT
CGAGAACTGGT -> GAGAACTGGTC
GAGAACTGGTC -> AGAACTGGTCG
AGAACTGGTCG -> GAACTGGTCGT
GAACTGGTCGT -> AACTGGTCGTA
AACTGGTCGTA -> ACTGGTCGTAC
ACTGGTCGTAC -> CTGGTCGTACT
CTGGTCGTACT -> TGGTCGTACTA
TGGTCGTACTA -> GGTCGTACTAT
GGTCGTACTAT -> GTCGTACTATT
GTCGTACTATT -> TCGTACTATTG
TCGTACTATTG -> CGTACTATTGT
CGTACTATTGT -> GTACTATTGTG
GTACTATTGTG -> TACTATTGTGC
TACTATTGTGC -> ACTATTGTGCC
ACTATTGTGCC -> CTATTGTGCCG
CTATTGTGCCG -> TATTGTGCCGT
TATTGTGCCGT -> ATTGTGCCGTC
ATTGTGCCGTC -> TTGTGCCGTCA
TTGTGCCGTCA -> TGTGCCGTCAC
TGTGCCGTCAC -> GTGCCGTCACG
GTGCCGTCACG -> TGCCGTCACGG
TGCCGTCACGG -> GCCGTCACGGG
GCCGTCACGGG -> CCGTCACGGGC
CCGTCACGGGC -> CGTCACGGGCG
CGTCACGGGCG -> GTCACGGGCGG
GTCACGGGCGG -> TCACGGGCGGA
TCACGGGCGGA -> CACGGGCGGAT
CACGGGCGGAT -> ACGGGCGGATT
ACGGGCGGATT -> CGGGCGGATTT
CGGGCGGATTT -> GGGCGGATTTG
GGGCGGATTTG -> GGCGGATTTGC
GGCGGATTTGC -> GCGGATTTGCC
GCGGATTTGCC -> CGGATTTGCCG
CGGATTTGCCG -> GGATTTGCCGG
GGATTTGCCGG -> GATTTGCCGGG
GATTTGCCGGG -> ATTTGCCGGGA
ATTTGCCGGGA -> TTTGCCGGGAC
TTTGCCGGGAC -> TTGCCGGGACT
TTGCCGGGACT -> TGCCGGGACTT
TGCCGGGACTT -> GCCGGGACTTG
GCCGGGACTTG -> CCGGGACTTGT
CCGGGACTTGT -> CGGGACTTGTT
CGGGACTTGTT -> GGGACTTGTTC
GGGACTTGTTC -> GGACTTGTTCC
GGACTTGTTCC -> GACTTGTTCCT
GACTTGTTCCT -> ACTTGTTCCTG
ACTTGTTCCTG -> CTTGTTCCTGA
CTTGTTCCTGA -> TTGTTCCTGAG
TTGTTCCTGAG -> TGTTCCTGAGG
TGTTCCTGAGG -> GTTCCTGAGGC
GTTCCTGAGGC -> TTCCTGAGGCT
TTCCTGAGGCT -> TCCTGAGGCTG
TCCTGAGGCTG -> CCTGAGGCTGC
CCTGAGGCTGC -> CTGAGGCTGCG
CTGAGGCTGCG -> TGAGGCTGCGT
TGAGGCTGCGT -> GAGGCTGCGTA
GAGGCTGCGTA -> AGGCTGCGTAT
AGGCTGCGTAT -> GGCTGCGTATA
GGCTGCGTATA -> GCTGCGTATAA
GCTGCGTATAA -> CTGCGTATAAC
CTGCGTATAAC -> TGCGTATAACT
TGCGTATAACT -> GCGTATAACTT
GCGTATAACTT -> CGTATAACTTG
CGTATAACTTG -> GTATAACTTGA
GTATAACTTGA -> TATAACTTGAA
TATAACTTGAA -> ATAACTTGAAT
ATAACTTGAAT -> TAACTTGAATG
TAACTTGAATG -> AACTTGAATGT
AACTTGAATGT -> ACTTGAATGTC
ACTTGAATGTC -> CTTGAATGTCC
CTTGAATGTCC -> TTGAATGTCCC
TTGAATGTCCC -> TGAATGTCCCC
TGAATGTCCCC -> GAATGTCCCCC
GAATGTCCCCC -> AATGTCCCCCT
AATGTCCCCCT -> ATGTCCCCCTG
ATGTCCCCCTG -> TGTCCCCCTGG
TGTCCCCCTGG -> GTCCCCCTGGT
GTCCCCCTGGT -> TCCCCCTGGTA
TCCCCCTGGTA -> CCCCCTGGTAT
CCCCCTGGTAT -> CCCCTGGTATC
CCCCTGGTATC -> CCCTGGTATCC
CCCTGGTATCC -> CCTGGTATCCC
CCTGGTATCCC -> CTGGTATCCCT
CTGGTATCCCT -> TGGTATCCCTG
TGGTATCCCTG -> GGTATCCCTGG
GGTATCCCTGG -> GTATCCCTGGA
GTATCCCTGGA -> TATCCCTGGAA
TATCCCTGGAA -> ATCCCTGGAAC
ATCCCTGGAAC -> TCCCTGGAACG
TCCCTGGAACG -> CCCTGGAACGT
CCCTGGAACGT -> CCTGGAACGTC
CCTGGAACGTC -> CTGGAACGTCC
CTGGAACGTCC -> TGGAACGTCCA
TGGAACGTCCA -> GGAACGTCCAG
GGAACGTCCAG -> GAACGTCCAGA
GAACGTCCAGA -> AACGTCCAGAT
AACGTCCAGAT -> ACGTCCAGATT
ACGTCCAGATT -> CGTCCAGATTT
CGTCCAGATTT -> GTCCAGATTTC
GTCCAGATTTC -> TCCAGATTTCT
TCCAGATTTCT -> CCAGATTTCTT
CCAGATTTCTT -> CAGATTTCTTA
CAGATTTCTTA -> AGATTTCTTAC
AGATTTCTTAC -> GATTTCTTACA
GATTTCTTACA -> ATTTCTTACAG
ATTTCTTACAG -> TTTCTTACAGG
TTTCTTACAGG -> TTCTTACAGGA
TTCTTACAGGA -> TCTTACAGGAT
TCTTACAGGAT -> CTTACAGGATA
CTTACAGGATA -> TTACAGGATAG
TTACAGGATAG -> TACAGGATAGC
TACAGGATAGC -> ACAGGATAGCG
ACAGGATAGCG -> CAGGATAGCGT
CAGGATAGCGT -> AGGATAGCGTC
AGGATAGCGTC -> GGATAGCGTCA
GGATAGCGTCA -> GATAGCGTCAT
GATAGCGTCAT -> ATAGCGTCATG
ATAGCGTCATG -> TAGCGTCATGA
TAGCGTCATGA -> AGCGTCATGAC
AGCGTCATGAC -> GCGTCATGACG
GCGTCATGACG -> CGTCATGACGC
CGTCATGACGC -> GTCATGACGCA
GTCATGACGCA -> TCATGACGCAT
TCATGACGCAT -> CATGACGCATA
CATGACGCATA -> ATGACGCATAA
ATGACGCATAA -> TGACGCATAAG
TGACGCATAAG -> GACGCATAAGG
GACGCATAAGG -> ACGCATAAGGC
ACGCATAAGGC -> CGCATAAGGCG
CGCATAAGGCG -> GCATAAGGCGA
GCATAAGGCGA -> CATAAGGCGAG
CATAAGGCGAG -> ATAAGGCGAGT
ATAAGGCGAGT -> TAAGGCGAGTA
TAAGGCGAGTA -> AAGGCGAGTAA
AAGGCGAGTAA -> AGGCGAGTAAG
AGGCGAGTAAG -> GGCGAGTAAGC
GGCGAGTAAGC -> GCGAGTAAGCT
GCGAGTAAGCT -> CGAGTAAGCTA
CGAGTAAGCTA -> GAGTAAGCTAC
GAGTAAGCTAC -> AGTAAGCTACA
AGTAAGCTACA -> GTAAGCTACAG
GTAAGCTACAG -> TAAGCTACAGG
TAAGCTACAGG -> AAGCTACAGGC
AAGCTACAGGC -> AGCTACAGGCG
AGCTACAGGCG -> GCTACAGGCGA
GCTACAGGCGA -> CTACAGGCGAC
CTACAGGCGAC -> TACAGGCGACA
TACAGGCGACA -> ACAGGCGACAT
ACAGGCGACAT -> CAGGCGACATC
CAGGCGACATC -> AGGCGACATCG
AGGCGACATCG -> GGCGACATCGA
GGCGACATCGA -> GCGACATCGAA
GCGACATCGAA -> CGACATCGAAT
CGACATCGAAT -> GACATCGAATC
GACATCGAATC -> ACATCGAATCA
ACATCGAATCA -> CATCGAATCAA
CATCGAATCAA -> ATCGAATCAAG
ATCGAATCAAG -> TCGAATCAAGT
TCGAATCAAGT -> CGAATCAAGTG
CGAATCAAGTG -> GAATCAAGTGT
GAATCAAGTGT -> AATCAAGTGTA
AATCAAGTGTA -> ATCAAGTGTAA
ATCAAGTGTAA -> TCAAGTGTAAG
TCAAGTGTAAG -> CAAGTGTAAGT
CAAGTGTAAGT -> AAGTGTAAGTG
AAGTGTAAGTG -> AGTGTAAGTGA
AGTGTAAGTGA -> GTGTAAGTGAG
GTGTAAGTGAG -> TGTAAGTGAGC
TGTAAGTGAGC -> GTAAGTGAGCG
GTAAGTGAGCG -> TAAGTGAGCGT
TAAGTGAGCGT -> AAGTGAGCGTC
AAGTGAGCGTC -> AGTGAGCGTCT
AGTGAGCGTCT -> GTGAGCGTCTA
GTGAGCGTCTA -> TGAGCGTCTAT
TGAGCGTCTAT -> GAGCGTCTATT
GAGCGTCTATT -> AGCGTCTATTC
AGCGTCTATTC -> GCGTCTATTCC
GCGTCTATTCC -> CGTCTATTCCT
CGTCTATTCCT -> GTCTATTCCTG
GTCTATTCCTG -> TCTATTCCTGT
TCTATTCCTGT -> CTATTCCTGTG
CTATTCCTGTG -> TATTCCTGTGC
TATTCCTGTGC -> ATTCCTGTGCT
ATTCCTGTGCT -> TTCCTGTGCTT
TTCCTGTGCTT -> TCCTGTGCTTT
TCCTGTGCTTT -> CCTGTGCTTTA
CCTGTGCTTTA -> CTGTGCTTTAA
CTGTGCTTTAA -> TGTGCTTTAAT
TGTGCTTTAAT -> GTGCTTTAATG
GTGCTTTAATG -> TGCTTTAATGA
TGCTTTAATGA -> GCTTTAATGAC
GCTTTAATGAC -> CTTTAATGACC
CTTTAATGACC -> TTTAATGACCT
TTTAATGACCT -> TTAATGACCTA
TTAATGACCTA -> TAATGACCTAC
TAATGACCTAC -> AATGACCTACT
AATGACCTACT -> ATGACCTACTT
ATGACCTACTT -> TGACCTACTTG
TGACCTACTTG -> GACCTACTTGT
GACCTACTTGT -> ACCTACTTGTT
ACCTACTTGTT -> CCTACTTGTTA
CCTACTTGTTA -> CTACTTGTTAA
CTACTTGTTAA -> TACTTGTTAAT
TACTTGTTAAT -> ACTTGTTAATT
ACTTGTTAATT -> CTTGTTAATTG
CTTGTTAATTG -> TTGTTAATTGA
TTGTTAATTGA -> TGTTAATTGAT
TGTTAATTGAT -> GTTAATTGATG
GTTAATTGATG -> TTAATTGATGC
TTAATTGATGC -> TAATTGATGCC
TAATTGATGCC -> AATTGATGCCA
AATTGATGCCA -> ATTGATGCCAT
ATTGATGCCAT -> TTGATGCCATC
TTGATGCCATC -> TGATGCCATCA
TGATGCCATCA -> GATGCCATCAA
GATGCCATCAA -> ATGCCATCAAA
ATGCCATCAAA -> TGCCATCAAAG
TGCCATCAAAG -> GCCATCAAAGA
GCCATCAAAGA -> CCATCAAAGAT
CCATCAAAGAT -> CATCAAAGATG
CATCAAAGATG -> ATCAAAGATGT
ATCAAAGATGT -> TCAAAGATGTC
TCAAAGATGTC -> CAAAGATGTCG
CAAAGATGTCG -> AAAGATGTCGG
AAAGATGTCGG -> AAGATGTCGGC
AAGATGTCGGC -> AGATGTCGGCG
AGATGTCGGCG -> GATGTCGGCGA
GATGTCGGCGA -> ATGTCGGCGAG
ATGTCGGCGAG -> TGTCGGCGAGA
TGTCGGCGAGA -> GTCGGCGAGAG
GTCGGCGAGAG -> TCGGCGAGAGA
TCGGCGAGAGA -> CGGCGAGAGAC
CGGCGAGAGAC -> GGCGAGAGACG
GGCGAGAGACG -> GCGAGAGACGG
GCGAGAGACGG -> CGAGAGACGGG
CGAGAGACGGG -> GAGAGACGGGG
GAGAGACGGGG -> AGAGACGGGGT
AGAGACGGGGT -> GAGACGGGGTT
GAGACGGGGTT -> AGACGGGGTTC
AGACGGGGTTC -> GACGGGGTTCG
GACGGGGTTCG -> ACGGGGTTCGA
ACGGGGTTCGA -> CGGGGTTCGAA
CGGGGTTCGAA -> GGGGTTCGAAT
GGGGTTCGAAT -> GGGTTCGAATA
GGGTTCGAATA -> GGTTCGAATAG
GGTTCGAATAG -> GTTCGAATAGA
GTTCGAATAGA -> TTCGAATAGAT
TTCGAATAGAT -> TCGAATAGATC
TCGAATAGATC -> CGAATAGATCC
CGAATAGATCC -> GAATAGATCCT
GAATAGATCCT -> AATAGATCCTA
AATAGATCCTA -> ATAGATCCTAT
ATAGATCCTAT -> TAGATCCTATT
TAGATCCTATT -> AGATCCTATTC
AGATCCTATTC -> GATCCTATTCC
GATCCTATTCC -> ATCCTATTCCC
ATCCTATTCCC -> TCCTATTCCCA
TCCTATTCCCA -> CCTATTCCCAG
CCTATTCCCAG -> CTATTCCCAGT
CTATTCCCAGT -> TATTCCCAGTT
TATTCCCAGTT -> ATTCCCAGTTC
ATTCCCAGTTC -> TTCCCAGTTCG
TTCCCAGTTCG -> TCCCAGTTCGT
TCCCAGTTCGT -> CCCAGTTCGTG
CCCAGTTCGTG -> CCAGTTCGTGT
CCAGTTCGTGT -> CAGTTCGTGTA
CAGTTCGTGTA -> AGTTCGTGTAC
AGTTCGTGTAC -> GTTCGTGTACA
GTTCGTGTACA -> TTCGTGTACAC
TTCGTGTACAC -> TCGTGTACACT
TCGTGTACACT -> CGTGTACACTA
CGTGTACACTA -> GTGTACACTAA
GTGTACACTAA -> TGTACACTAAA
TGTACACTAAA -> GTACACTAAAG
GTACACTAAAG -> TACACTAAAGG
TACACTAAAGG -> ACACTAAAGGT
ACACTAAAGGT -> CACTAAAGGTT
CACTAAAGGTT -> ACTAAAGGTTG
ACTAAAGGTTG -> CTAAAGGTTGG
CTAAAGGTTGG -> TAAAGGTTGGG
TAAAGGTTGGG -> AAAGGTTGGGC
AAAGGTTGGGC -> AAGGTTGGGCA
AAGGTTGGGCA -> AGGTTGGGCAC
AGGTTGGGCAC -> GGTTGGGCACT
GGTTGGGCACT -> GTTGGGCACTG
GTTGGGCACTG -> TTGGGCACTGG
TTGGGCACTGG -> TGGGCACTGGG
TGGGCACTGGG -> GGGCACTGGGG
GGGCACTGGGG -> GGCACTGGGGC
GGCACTGGGGC -> GCACTGGGGCG
GCACTGGGGCG -> CACTGGGGCGA
CACTGGGGCGA -> ACTGGGGCGAC
ACTGGGGCGAC -> CTGGGGCGACT
CTGGGGCGACT -> TGGGGCGACTC
TGGGGCGACTC -> GGGGCGACTCC
GGGGCGACTCC -> GGGCGACTCCA
GGGCGACTCCA -> GGCGACTCCAC
GGCGACTCCAC -> GCGACTCCACC
GCGACTCCACC -> CGACTCCACCA
CGACTCCACCA -> GACTCCACCAC
GACTCCACCAC -> ACTCCACCACT
ACTCCACCACT -> CTCCACCACTC
CTCCACCACTC -> TCCACCACTCT
TCCACCACTCT -> CCACCACTCTT
CCACCACTCTT -> CACCACTCTTT
CACCACTCTTT -> ACCACTCTTTT
ACCACTCTTTT -> CCACTCTTTTA
CCACTCTTTTA -> CACTCTTTTAC
CACTCTTTTAC -> ACTCTTTTACG
ACTCTTTTACG -> CTCTTTTACGG
CTCTTTTACGG -> TCTTTTACGGC
TCTTTTACGGC -> CTTTTACGGCC
CTTTTACGGCC -> TTTTACGGCCA
TTTTACGGCCA -> TTTACGGCCAC
TTTACGGCCAC -> TTACGGCCACG
TTACGGCCACG -> TACGGCCACGA
TACGGCCACGA -> ACGGCCACGAA
ACGGCCACGAA -> CGGCCACGAAC
CGGCCACGAAC -> GGCCACGAACT
GGCCACGAACT -> GCCACGAACTA
GCCACGAACTA -> CCACGAACTAA
CCACGAACTAA -> CACGAACTAAT
CACGAACTAAT -> ACGAACTAATT
ACGAACTAATT -> CGAACTAATTT
CGAACTAATTT -> GAACTAATTTA
GAACTAATTTA -> AACTAATTTAA
AACTAATTTAA -> ACTAATTTAAA
ACTAATTTAAA -> CTAATTTAAAA
CTAATTTAAAA -> TAATTTAAAAT
TAATTTAAAAT -> AATTTAAAATT
AATTTAAAATT -> ATTTAAAATTG
ATTTAAAATTG -> TTTAAAATTGA
TTTAAAATTGA -> TTAAAATTGAA
TTAAAATTGAA -> TAAAATTGAAC
TAAAATTGAAC -> AAAATTGAACA
AAAATTGAACA -> AAATTGAACAT
AAATTGAACAT -> AATTGAACATG
AATTGAACATG -> ATTGAACATGC
ATTGAACATGC -> TTGAACATGCG
TTGAACATGCG -> TGAACATGCGG
TGAACATGCGG -> GAACATGCGGC
GAACATGCGGC -> AACATGCGGCA
AACATGCGGCA -> ACATGCGGCAA
ACATGCGGCAA -> CATGCGGCAAA
CATGCGGCAAA -> ATGCGGCAAAG
ATGCGGCAAAG -> TGCGGCAAAGT
TGCGGCAAAGT -> GCGGCAAAGTA
GCGGCAAAGTA -> CGGCAAAGTAC
CGGCAAAGTAC -> GGCAAAGTACC
GGCAAAGTACC -> GCAAAGTACCA
GCAAAGTACCA -> CAAAGTACCAA
CAAAGTACCAA -> AAAGTACCAAT
AAAGTACCAAT -> AAGTACCAATC
AAGTACCAATC -> AGTACCAATCC
AGTACCAATCC -> GTACCAATCCA
GTACCAATCCA -> TACCAATCCAG
TACCAATCCAG -> ACCAATCCAGT
ACCAATCCAGT -> CCAATCCAGTA
CCAATCCAGTA -> CAATCCAGTAT
CAATCCAGTAT -> AATCCAGTATG
AATCCAGTATG -> ATCCAGTATGA
ATCCAGTATGA -> TCCAGTATGAA
TCCAGTATGAA -> CCAGTATGAAG
CCAGTATGAAG -> CAGTATGAAGA
CAGTATGAAGA -> AGTATGAAGAG
AGTATGAAGAG -> GTATGAAGAGC
GTATGAAGAGC -> TATGAAGAGCA
TATGAAGAGCA -> ATGAAGAGCAA
ATGAAGAGCAA -> TGAAGAGCAAT
TGAAGAGCAAT -> GAAGAGCAATA
GAAGAGCAATA -> AAGAGCAATAG
AAGAGCAATAG -> AGAGCAATAGT
AGAGCAATAGT -> GAGCAATAGTT
GAGCAATAGTT -> AGCAATAGTTT
AGCAATAGTTT -> GCAATAGTTTC
GCAATAGTTTC -> CAATAGTTTCA
CAATAGTTTCA -> AATAGTTTCAC
AATAGTTTCAC -> ATAGTTTCACG
ATAGTTTCACG -> TAGTTTCACGC
TAGTTTCACGC -> AGTTTCACGCG
AGTTTCACGCG -> GTTTCACGCGT
GTTTCACGCGT -> TTTCACGCGTC
TTTCACGCGTC -> TTCACGCGTCG
TTCACGCGTCG -> TCACGCGTCGG
TCACGCGTCGG -> CACGCGTCGGG
CACGCGTCGGG -> ACGCGTCGGGG
ACGCGTCGGGG -> CGCGTCGGGGA
CGCGTCGGGGA -> GCGTCGGGGAA
GCGTCGGGGAA -> CGTCGGGGAAT
CGTCGGGGAAT -> GTCGGGGAATA
GTCGGGGAATA -> TCGGGGAATAA
TCGGGGAATAA -> CGGGGAATAAA
CGGGGAATAAA -> GGGGAATAAAG
GGGGAATAAAG -> GGGAATAAAGC
GGGAATAAAGC -> GGAATAAAGCT
GGAATAAAGCT -> GAATAAAGCTA
GAATAAAGCTA -> AATAAAGCTAC
AATAAAGCTAC -> ATAAAGCTACC
ATAAAGCTACC -> TAAAGCTACCC
TAAAGCTACCC -> AAAGCTACCCA
AAAGCTACCCA -> AAGCTACCCAA
AAGCTACCCAA -> AGCTACCCAAT
AGCTACCCAAT -> GCTACCCAATA
GCTACCCAATA -> CTACCCAATAC
CTACCCAATAC -> TACCCAATACG
TACCCAATACG -> ACCCAATACGC
ACCCAATACGC -> CCCAATACGCT
CCCAATACGCT -> CCAATACGCTA
CCAATACGCTA -> CAATACGCTAT
CAATACGCTAT -> AATACGCTATA
AATACGCTATA -> ATACGCTATAA
ATACGCTATAA -> TACGCTATAAT
TACGCTATAAT -> ACGCTATAATT
ACGCTATAATT -> CGCTATAATTT
CGCTATAATTT -> GCTATAATTTA
GCTATAATTTA -> CTATAATTTAT
CTATAATTTAT -> TATAATTTATC
