AAAAACCAAAGGAACGACC -> AAAACCAAAGGAACGACCA
AAAACACGTATTAGCACTC -> AAACACGTATTAGCACTCA
AAAACCAAAGGAACGACCA -> AAACCAAAGGAACGACCAG
AAAAGCAGCGGCAGATTGA -> AAAGCAGCGGCAGATTGAG
AAAAGTCCTCAGCACTATA -> AAAGTCCTCAGCACTATAT
AAAATACCTACCACATACG -> AAATACCTACCACATACGC
AAAATGCTGCTCGTACGAA -> AAATGCTGCTCGTACGAAC
AAAATTCCCAGGTCGTCTC -> AAATTCCCAGGTCGTCTCC
AAACACGTATTAGCACTCA -> AACACGTATTAGCACTCAC
AAACAGTCGACTCGCGTGA -> AACAGTCGACTCGCGTGAA
AAACATAGGACCGCGGCTA -> AACATAGGACCGCGGCTAA
AAACATCTTATCGAGTCGG -> AACATCTTATCGAGTCGGG
AAACCAAAGGAACGACCAG -> AACCAAAGGAACGACCAGC
AAACTTGGATTCCCTTTGT -> AACTTGGATTCCCTTTGTG
AAACTTTCCAGGCGAGGTT -> AACTTTCCAGGCGAGGTTG
AAAGAAGCGTTGCCTTACG -> AAGAAGCGTTGCCTTACGT
AAAGACTATGTACCAACGT -> AAGACTATGTACCAACGTA
AAAGCAGCGGCAGATTGAG -> AAGCAGCGGCAGATTGAGT
AAAGCGGCTCATGTGAAGG -> AAGCGGCTCATGTGAAGGA
AAAGGAACGACCAGCCGGT -> AAGGAACGACCAGCCGGTT
AAAGTACATCCGTTAGCGC -> AAGTACATCCGTTAGCGCA
AAAGTCCTCAGCACTATAT -> AAGTCCTCAGCACTATATG
AAAGTCTCGTGGAGCCTAG -> AAGTCTCGTGGAGCCTAGC
AAATACCTACCACATACGC -> AATACCTACCACATACGCG
AAATACTGACCGAGATCCG -> AATACTGACCGAGATCCGG
AAATCACAAGGCACCTCAG -> AATCACAAGGCACCTCAGG
AAATCGCGTGCCACAGAGC -> AATCGCGTGCCACAGAGCG
AAATCTACAGGCCCCGTAG -> AATCTACAGGCCCCGTAGT
AAATCTAGCTGTTGAAGCA -> AATCTAGCTGTTGAAGCAC
AAATGACGAGCCGAATTAC -> AATGACGAGCCGAATTACT
AAATGATATATGCCCCCTA -> AATGATATATGCCCCCTAT
AAATGCTGCTCGTACGAAC -> AATGCTGCTCGTACGAACA
AAATTCCCAGGTCGTCTCC -> AATTCCCAGGTCGTCTCCG
AACAATCACATCTACTGAA -> ACAATCACATCTACTGAAG
AACACGTATTAGCACTCAC -> ACACGTATTAGCACTCACA
AACAGAGCCGCGTCTCCTG -> ACAGAGCCGCGTCTCCTGG
AACAGATAACTTTCAATTG -> ACAGATAACTTTCAATTGA
AACAGTAATGACATATCGA -> ACAGTAATGACATATCGAA
AACAGTCGACTCGCGTGAA -> ACAGTCGACTCGCGTGAAC
AACATAGCTATGTCTGTGG -> ACATAGCTATGTCTGTGGT
AACATAGGACCGCGGCTAA -> ACATAGGACCGCGGCTAAA
AACATCTTATCGAGTCGGG -> ACATCTTATCGAGTCGGGA
AACATTGGCTACGTCCCGA -> ACATTGGCTACGTCCCGAC
AACCAAAGGAACGACCAGC -> ACCAAAGGAACGACCAGCC
AACCAATATTACCCAACGC -> ACCAATATTACCCAACGCT
AACCCACAAAGTACATCCG -> ACCCACAAAGTACATCCGT
AACCCCTCCCGCAACCAAT -> ACCCCTCCCGCAACCAATA
AACCCGATCCTACTGATTT -> ACCCGATCCTACTGATTTC
AACCGCACGGATGATAGAC -> ACCGCACGGATGATAGACT
AACCTGTAATCTTCAGCAA -> ACCTGTAATCTTCAGCAAA
AACGACCAGCCGGTTTACC -> ACGACCAGCCGGTTTACCC
AACGATTGTCTTCAGAACC -> ACGATTGTCTTCAGAACCC
AACGCACAGTGATTGGAGG -> ACGCACAGTGATTGGAGGG
AACGCAGACGTGCTAGATA -> ACGCAGACGTGCTAGATAC
AACGCTAGAGGAAGCGCCA -> ACGCTAGAGGAAGCGCCAA
AACGTACTTGTGACGCTCT -> ACGTACTTGTGACGCTCTG
AACGTCCATAGAGCTGTGA -> ACGTCCATAGAGCTGTGAG
AACTAACAGATAACTTTCA -> ACTAACAGATAACTTTCAA
AACTGGCATGCTGCACAAA -> ACTGGCATGCTGCACAAAC
AACTTGGATTCCCTTTGTG -> ACTTGGATTCCCTTTGTGC
AACTTTCAATTGATGGAAG -> ACTTTCAATTGATGGAAGC
AACTTTCCAGGCGAGGTTG -> ACTTTCCAGGCGAGGTTGT
AAGAAAGACTATGTACCAA -> AGAAAGACTATGTACCAAC
AAGAAGCGTTGCCTTACGT -> AGAAGCGTTGCCTTACGTA
AAGACGACGCCATGGATCT -> AGACGACGCCATGGATCTT
AAGACTATCACGTGGTACT -> AGACTATCACGTGGTACTA
AAGACTATGTACCAACGTA -> AGACTATGTACCAACGTAC
AAGACTGTCCTGATTATTT -> AGACTGTCCTGATTATTTA
AAGATAAGTCGTAACATTG -> AGATAAGTCGTAACATTGG
AAGATAGTTCGCTTTAATC -> AGATAGTTCGCTTTAATCA
AAGATTAGCCCCCTCTGGT -> AGATTAGCCCCCTCTGGTT
AAGCACCATAGTTGTCATC -> AGCACCATAGTTGTCATCC
AAGCAGCGGCAGATTGAGT -> AGCAGCGGCAGATTGAGTG
AAGCCGAACTGGCATGCTG -> AGCCGAACTGGCATGCTGC
AAGCGCCAATTAAGATAAG -> AGCGCCAATTAAGATAAGT
AAGCGGCTCATGTGAAGGA -> AGCGGCTCATGTGAAGGAT
AAGCGTTGCCTTACGTATT -> AGCGTTGCCTTACGTATTT
AAGCTCTTGCTGTCTCGCT -> AGCTCTTGCTGTCTCGCTG
AAGCTGGTGTCGGCAATTC -> AGCTGGTGTCGGCAATTCT
AAGCTTACGTCAGCAGGAT -> AGCTTACGTCAGCAGGATA
AAGGAACGACCAGCCGGTT -> AGGAACGACCAGCCGGTTT
AAGGATCGAGGGGACCAGC -> AGGATCGAGGGGACCAGCC
AAGGCACCTCAGGAATATA -> AGGCACCTCAGGAATATAT
AAGGGGTGAGATCGTTACT -> AGGGGTGAGATCGTTACTC
AAGGTGGTTCTGACAGTAT -> AGGTGGTTCTGACAGTATG
AAGTACATCCGTTAGCGCA -> AGTACATCCGTTAGCGCAC
AAGTCCTCAGCACTATATG -> AGTCCTCAGCACTATATGA
AAGTCGCAGGTCTCGCCTG -> AGTCGCAGGTCTCGCCTGC
AAGTCGTAACATTGGCTAC -> AGTCGTAACATTGGCTACG
AAGTCTCGTGGAGCCTAGC -> AGTCTCGTGGAGCCTAGCA
AAGTCTTGCTTAATGGGGT -> AGTCTTGCTTAATGGGGTT
AAGTGCGAAGACGACGCCA -> AGTGCGAAGACGACGCCAT
AAGTGGGTAGTCCATTTTG -> AGTGGGTAGTCCATTTTGA
AAGTGTGGGGCCTATCATT -> AGTGTGGGGCCTATCATTG
AATACCTACCACATACGCG -> ATACCTACCACATACGCGT
AATACCTGTCAAAGTCTCG -> ATACCTGTCAAAGTCTCGT
AATACTGACCGAGATCCGG -> ATACTGACCGAGATCCGGC
AATACTTCGGGGGCTTTTT -> ATACTTCGGGGGCTTTTTT
AATATATTCCACTGGAGCC -> ATATATTCCACTGGAGCCG
AATATTACCCAACGCTAGA -> ATATTACCCAACGCTAGAG
AATATTGATCGGTGTAACC -> ATATTGATCGGTGTAACCC
AATCACAAGGCACCTCAGG -> ATCACAAGGCACCTCAGGA
AATCACAAGTCTTGCTTAA -> ATCACAAGTCTTGCTTAAT
AATCACATCTACTGAAGAT -> ATCACATCTACTGAAGATT
AATCAGGCCTGACGGGCGT -> ATCAGGCCTGACGGGCGTT
AATCATGAAATACTGACCG -> ATCATGAAATACTGACCGA
AATCATGCGGCGCATTCCA -> ATCATGCGGCGCATTCCAA
AATCCCGCCTCTCACGGCT -> ATCCCGCCTCTCACGGCTA
AATCGCGTGCCACAGAGCG -> ATCGCGTGCCACAGAGCGG
AATCTACAGGCCCCGTAGT -> ATCTACAGGCCCCGTAGTA
AATCTAGCTGTTGAAGCAC -> ATCTAGCTGTTGAAGCACC
AATCTGCTTGGACGCTCTG -> ATCTGCTTGGACGCTCTGC
AATCTTCAGCAAATGATAT -> ATCTTCAGCAAATGATATA
AATGACATATCGAACTAAC -> ATGACATATCGAACTAACA
AATGACGAGCCGAATTACT -> ATGACGAGCCGAATTACTA
AATGAGACCTGAGCAAAAG -> ATGAGACCTGAGCAAAAGC
AATGATATATGCCCCCTAT -> ATGATATATGCCCCCTATT
AATGCTGCTCGTACGAACA -> ATGCTGCTCGTACGAACAA
AATGGGAAAAACCAAAGGA -> ATGGGAAAAACCAAAGGAA
AATGGGGTTCTAGCGGCCC -> ATGGGGTTCTAGCGGCCCA
AATTAAGATAAGTCGTAAC -> ATTAAGATAAGTCGTAACA
AATTACTAAAAGTCCTCAG -> ATTACTAAAAGTCCTCAGC
AATTCCCAGGTCGTCTCCG -> ATTCCCAGGTCGTCTCCGG
AATTCTATATCCGAAGCTC -> ATTCTATATCCGAAGCTCT
AATTGATGGAAGCTTACGT -> ATTGATGGAAGCTTACGTC
AATTGTCAGCTTATCGAGT -> ATTGTCAGCTTATCGAGTC
ACAAACTTGGATTCCCTTT -> CAAACTTGGATTCCCTTTG
ACAAAGTACATCCGTTAGC -> CAAAGTACATCCGTTAGCG
ACAACGTCCATAGAGCTGT -> CAACGTCCATAGAGCTGTG
ACAAGGCACCTCAGGAATA -> CAAGGCACCTCAGGAATAT
ACAAGGGGTGAGATCGTTA -> CAAGGGGTGAGATCGTTAC
ACAAGTCGCAGGTCTCGCC -> CAAGTCGCAGGTCTCGCCT
ACAAGTCTTGCTTAATGGG -> CAAGTCTTGCTTAATGGGG
ACAATATTGATCGGTGTAA -> CAATATTGATCGGTGTAAC
ACAATCACATCTACTGAAG -> CAATCACATCTACTGAAGA
ACACGTATTAGCACTCACA -> CACGTATTAGCACTCACAG
ACACGTGAAATCTAGCTGT -> CACGTGAAATCTAGCTGTT
ACAGAGCCGCGTCTCCTGG -> CAGAGCCGCGTCTCCTGGC
ACAGAGCGGGCAATCTGCT -> CAGAGCGGGCAATCTGCTT
ACAGATAACTTTCAATTGA -> CAGATAACTTTCAATTGAT
ACAGCGAGACGTACAAGTC -> CAGCGAGACGTACAAGTCG
ACAGGCCCCGTAGTACCCA -> CAGGCCCCGTAGTACCCAA
ACAGGCGCGCGTCAGAGAA -> CAGGCGCGCGTCAGAGAAG
ACAGTAATGACATATCGAA -> CAGTAATGACATATCGAAC
ACAGTATGCCACTCATGGC -> CAGTATGCCACTCATGGCC
ACAGTCGACCGCCTCCGGT -> CAGTCGACCGCCTCCGGTC
ACAGTCGACTCGCGTGAAC -> CAGTCGACTCGCGTGAACG
ACAGTGATTGGAGGGCGTG -> CAGTGATTGGAGGGCGTGG
ACATACAACGTCCATAGAG -> CATACAACGTCCATAGAGC
ACATACGCGTATTCGGGCC -> CATACGCGTATTCGGGCCC
ACATAGCTATGTCTGTGGT -> CATAGCTATGTCTGTGGTC
ACATAGGACCGCGGCTAAA -> CATAGGACCGCGGCTAAAA
ACATATCGAACTAACAGAT -> CATATCGAACTAACAGATA
ACATCCGTTAGCGCACCAA -> CATCCGTTAGCGCACCAAG
ACATCTACTGAAGATTAGC -> CATCTACTGAAGATTAGCC
ACATCTTATCGAGTCGGGA -> CATCTTATCGAGTCGGGAG
ACATTGGCTACGTCCCGAC -> CATTGGCTACGTCCCGACG
ACCAAACAGTCGACTCGCG -> CCAAACAGTCGACTCGCGT
ACCAAAGGAACGACCAGCC -> CCAAAGGAACGACCAGCCG
ACCAACGTACTTGTGACGC -> CCAACGTACTTGTGACGCT
ACCAAGCCGAACTGGCATG -> CCAAGCCGAACTGGCATGC
ACCAATATTACCCAACGCT -> CCAATATTACCCAACGCTA
ACCACATACGCGTATTCGG -> CCACATACGCGTATTCGGG
ACCACGGTCGTCGTAACCC -> CCACGGTCGTCGTAACCCC
ACCACTGACTGAAGATAGT -> CCACTGACTGAAGATAGTT
ACCAGCCGCTTCGTGCACG -> CCAGCCGCTTCGTGCACGC
ACCAGCCGGTTTACCCTGG -> CCAGCCGGTTTACCCTGGC
ACCATAGTTGTCATCCAAG -> CCATAGTTGTCATCCAAGA
ACCATCTACCTTATCGAGT -> CCATCTACCTTATCGAGTC
ACCCAACGCTAGAGGAAGC -> CCCAACGCTAGAGGAAGCG
ACCCAATCATGCGGCGCAT -> CCCAATCATGCGGCGCATT
ACCCACAAAGTACATCCGT -> CCCACAAAGTACATCCGTT
ACCCATAATTGTCAGCTTA -> CCCATAATTGTCAGCTTAT
ACCCCTACCATCTACCTTA -> CCCCTACCATCTACCTTAT
ACCCCTCCCGCAACCAATA -> CCCCTCCCGCAACCAATAT
ACCCGACAGTCGACCGCCT -> CCCGACAGTCGACCGCCTC
ACCCGATCCTACTGATTTC -> CCCGATCCTACTGATTTCT
ACCCGTACCGAGAGGCTTA -> CCCGTACCGAGAGGCTTAT
ACCCTACTCCGATGGATTT -> CCCTACTCCGATGGATTTC
ACCCTGGCCTAAACTTTCC -> CCCTGGCCTAAACTTTCCA
ACCCTTGCTAAACATCTTA -> CCCTTGCTAAACATCTTAT
ACCGAGAGGCTTATCGAGT -> CCGAGAGGCTTATCGAGTC
ACCGAGATCCGGCGAATAC -> CCGAGATCCGGCGAATACC
ACCGCACGGATGATAGACT -> CCGCACGGATGATAGACTG
ACCGCCTCCGGTCTCACTC -> CCGCCTCCGGTCTCACTCC
ACCGCGGCTAAAATACCTA -> CCGCGGCTAAAATACCTAC
ACCGCGTGGTAGAGTAGGT -> CCGCGTGGTAGAGTAGGTT
ACCTACCACATACGCGTAT -> CCTACCACATACGCGTATT
ACCTCAGGAATATATTCCA -> CCTCAGGAATATATTCCAC
ACCTGAGCAAAAGCAGCGG -> CCTGAGCAAAAGCAGCGGC
ACCTGTAATCTTCAGCAAA -> CCTGTAATCTTCAGCAAAT
ACCTGTCAAAGTCTCGTGG -> CCTGTCAAAGTCTCGTGGA
ACCTTATCGAGTCGGGAGG -> CCTTATCGAGTCGGGAGGG
ACGAACAATCACATCTACT -> CGAACAATCACATCTACTG
ACGAAGGTGGTTCTGACAG -> CGAAGGTGGTTCTGACAGT
ACGACCAGCCGGTTTACCC -> CGACCAGCCGGTTTACCCT
ACGACGCCATGGATCTTTG -> CGACGCCATGGATCTTTGT
ACGAGCCGAATTACTAAAA -> CGAGCCGAATTACTAAAAG
ACGAGTACGTGGATGTTCG -> CGAGTACGTGGATGTTCGA
ACGATTGTCTTCAGAACCC -> CGATTGTCTTCAGAACCCG
ACGCACAGTGATTGGAGGG -> CGCACAGTGATTGGAGGGC
ACGCACCCGACAGTCGACC -> CGCACCCGACAGTCGACCG
ACGCAGACGTGCTAGATAC -> CGCAGACGTGCTAGATACG
ACGCCATGGATCTTTGTCG -> CGCCATGGATCTTTGTCGT
ACGCGCTGCTCCTTTTGAT -> CGCGCTGCTCCTTTTGATG
ACGCGGCTCTGGTATATAC -> CGCGGCTCTGGTATATACA
ACGCGTATTCGGGCCCCCT -> CGCGTATTCGGGCCCCCTG
ACGCTAGAGGAAGCGCCAA -> CGCTAGAGGAAGCGCCAAT
ACGCTCCTCCCCATCGAAA -> CGCTCCTCCCCATCGAAAA
ACGCTCTGCAGTGACCCAT -> CGCTCTGCAGTGACCCATA
ACGCTCTGCAGTGACCCCT -> CGCTCTGCAGTGACCCCTA
ACGCTCTGCAGTGACCCGT -> CGCTCTGCAGTGACCCGTA
ACGCTCTGCAGTGACCCTT -> CGCTCTGCAGTGACCCTTG
ACGGACGCTCCTCCCCATC -> CGGACGCTCCTCCCCATCG
ACGGATGATAGACTGCATG -> CGGATGATAGACTGCATGT
ACGGCTAAGCTGGTGTCGG -> CGGCTAAGCTGGTGTCGGC
ACGGGCGTTCGTGTGACCA -> CGGGCGTTCGTGTGACCAC
ACGGTCGTCGTAACCCCTC -> CGGTCGTCGTAACCCCTCC
ACGTACAAGTCGCAGGTCT -> CGTACAAGTCGCAGGTCTC
ACGTACTTGTGACGCTCTG -> CGTACTTGTGACGCTCTGC
ACGTATTAGCACTCACAGC -> CGTATTAGCACTCACAGCG
ACGTATTTCGACGCTCTGC -> CGTATTTCGACGCTCTGCA
ACGTCAGCAGGATACCAAA -> CGTCAGCAGGATACCAAAC
ACGTCCATAGAGCTGTGAG -> CGTCCATAGAGCTGTGAGA
ACGTCCCGACGTCCCGCGT -> CGTCCCGACGTCCCGCGTC
ACGTCCCGCGTCCGCAGCC -> CGTCCCGCGTCCGCAGCCC
ACGTGAAATCTAGCTGTTG -> CGTGAAATCTAGCTGTTGA
ACGTGCTAGATACGTTTTG -> CGTGCTAGATACGTTTTGC
ACGTGGATGTTCGAGATAC -> CGTGGATGTTCGAGATACA
ACGTGGTACTAATGAGACC -> CGTGGTACTAATGAGACCT
ACGTTTTGCTCAGCTCAGG -> CGTTTTGCTCAGCTCAGGT
ACTAAAAGTCCTCAGCACT -> CTAAAAGTCCTCAGCACTA
ACTAACAGATAACTTTCAA -> CTAACAGATAACTTTCAAT
ACTAATGAGACCTGAGCAA -> CTAATGAGACCTGAGCAAA
ACTATATGATCTCCCAAAT -> CTATATGATCTCCCAAATC
ACTATCACGTGGTACTAAT -> CTATCACGTGGTACTAATG
ACTATCTGAGCTGTAGATG -> CTATCTGAGCTGTAGATGA
ACTATGTACCAACGTACTT -> CTATGTACCAACGTACTTG
ACTCACAGCGAGACGTACA -> CTCACAGCGAGACGTACAA
ACTCACGCACCCGACAGTC -> CTCACGCACCCGACAGTCG
ACTCATGGCCTTCGGCTAC -> CTCATGGCCTTCGGCTACT
ACTCCGATGGATTTCGATG -> CTCCGATGGATTTCGATGG
ACTCCGGCCTAACGATTGT -> CTCCGGCCTAACGATTGTC
ACTCGCGTGAACGCACAGT -> CTCGCGTGAACGCACAGTG
ACTGAAGATAGTTCGCTTT -> CTGAAGATAGTTCGCTTTA
ACTGAAGATTAGCCCCCTC -> CTGAAGATTAGCCCCCTCT
ACTGACCACGGTCGTCGTA -> CTGACCACGGTCGTCGTAA
ACTGACCGAGATCCGGCGA -> CTGACCGAGATCCGGCGAA
ACTGACTGAAGATAGTTCG -> CTGACTGAAGATAGTTCGC
ACTGATTTCTAAATGACGA -> CTGATTTCTAAATGACGAG
ACTGCATGTTCCCCGGGCT -> CTGCATGTTCCCCGGGCTT
ACTGCGGGAATCGGTAGGG -> CTGCGGGAATCGGTAGGGC
ACTGGAGCCGCCCAAACAT -> CTGGAGCCGCCCAAACATA
ACTGGCATGCTGCACAAAC -> CTGGCATGCTGCACAAACT
ACTGTCCTGATTATTTATA -> CTGTCCTGATTATTTATAG
ACTTCGGGGGCTTTTTTGT -> CTTCGGGGGCTTTTTTGTA
ACTTGGATTCCCTTTGTGC -> CTTGGATTCCCTTTGTGCT
ACTTGTGACGCTCTGCAGT -> CTTGTGACGCTCTGCAGTG
ACTTTCAATTGATGGAAGC -> CTTTCAATTGATGGAAGCT
ACTTTCCAGGCGAGGTTGT -> CTTTCCAGGCGAGGTTGTA
AGAAAGACTATGTACCAAC -> GAAAGACTATGTACCAACG
AGAACCCGATCCTACTGAT -> GAACCCGATCCTACTGATT
AGAACGCAGACGTGCTAGA -> GAACGCAGACGTGCTAGAT
AGAAGCGTTGCCTTACGTA -> GAAGCGTTGCCTTACGTAT
AGAAGTGGGTAGTCCATTT -> GAAGTGGGTAGTCCATTTT
AGAATACTTCGGGGGCTTT -> GAATACTTCGGGGGCTTTT
AGACCTGAGCAAAAGCAGC -> GACCTGAGCAAAAGCAGCG
AGACGAAGGTGGTTCTGAC -> GACGAAGGTGGTTCTGACA
AGACGACGCCATGGATCTT -> GACGACGCCATGGATCTTT
AGACGCTCTGCAGTGACCC -> GACGCTCTGCAGTGACCCA
AGACGGACGCTCCTCCCCA -> GACGGACGCTCCTCCCCAT
AGACGTACAAGTCGCAGGT -> GACGTACAAGTCGCAGGTC
AGACGTGCTAGATACGTTT -> GACGTGCTAGATACGTTTT
AGACTATCACGTGGTACTA -> GACTATCACGTGGTACTAA
AGACTATGTACCAACGTAC -> GACTATGTACCAACGTACT
AGACTGCATGTTCCCCGGG -> GACTGCATGTTCCCCGGGC
AGACTGTCCTGATTATTTA -> GACTGTCCTGATTATTTAT
AGAGAAGTGGGTAGTCCAT -> GAGAAGTGGGTAGTCCATT
AGAGAATACTTCGGGGGCT -> GAGAATACTTCGGGGGCTT
AGAGAGCATAATGGGAAAA -> GAGAGCATAATGGGAAAAA
AGAGCATAATGGGAAAAAC -> GAGCATAATGGGAAAAACC
AGAGCCGCGTCTCCTGGCG -> GAGCCGCGTCTCCTGGCGG
AGAGCGGGCAATCTGCTTG -> GAGCGGGCAATCTGCTTGG
AGAGCTGTGAGATCGGTAT -> GAGCTGTGAGATCGGTATT
AGAGGAAGCGCCAATTAAG -> GAGGAAGCGCCAATTAAGA
AGAGGCTTATCGAGTCGGG -> GAGGCTTATCGAGTCGGGA
AGAGGGAATCAGGCCTGAC -> GAGGGAATCAGGCCTGACG
AGAGTAGGTTCAACCTGTA -> GAGTAGGTTCAACCTGTAA
AGAGTCCAAGTGCGAAGAC -> GAGTCCAAGTGCGAAGACG
AGATAACTTTCAATTGATG -> GATAACTTTCAATTGATGG
AGATAAGTCGTAACATTGG -> GATAAGTCGTAACATTGGC
AGATACATACAACGTCCAT -> GATACATACAACGTCCATA
AGATACGTTTTGCTCAGCT -> GATACGTTTTGCTCAGCTC
AGATAGTTCGCTTTAATCA -> GATAGTTCGCTTTAATCAC
AGATCCGGCGAATACCTGT -> GATCCGGCGAATACCTGTC
AGATCGGTATTGTGCTCTA -> GATCGGTATTGTGCTCTAT
AGATCGTTACTCACGCACC -> GATCGTTACTCACGCACCC
AGATGATCATGTAGATTTA -> GATGATCATGTAGATTTAA
AGATGCATTTGGGAAGACT -> GATGCATTTGGGAAGACTA
AGATTAGCCCCCTCTGGTT -> GATTAGCCCCCTCTGGTTC
AGATTGAGTGAAGAAAGAC -> GATTGAGTGAAGAAAGACT
AGATTTAACCGCACGGATG -> GATTTAACCGCACGGATGA
AGCAAAAGCAGCGGCAGAT -> GCAAAAGCAGCGGCAGATT
AGCAAATGATATATGCCCC -> GCAAATGATATATGCCCCC
AGCACCATAGTTGTCATCC -> GCACCATAGTTGTCATCCA
AGCACTATATGATCTCCCA -> GCACTATATGATCTCCCAA
AGCACTCACAGCGAGACGT -> GCACTCACAGCGAGACGTA
AGCAGAGGGAATCAGGCCT -> GCAGAGGGAATCAGGCCTG
AGCAGCGGCAGATTGAGTG -> GCAGCGGCAGATTGAGTGA
AGCAGGATACCAAACAGTC -> GCAGGATACCAAACAGTCG
AGCATAATGGGAAAAACCA -> GCATAATGGGAAAAACCAA
AGCATCAGCAGAGGGAATC -> GCATCAGCAGAGGGAATCA
AGCATCTTTGGCGTAGCGA -> GCATCTTTGGCGTAGCGAA
AGCCCCCTCTGGTTCCTAC -> GCCCCCTCTGGTTCCTACA
AGCCCGTCTTCTATTAGGC -> GCCCGTCTTCTATTAGGCT
AGCCGAACTGGCATGCTGC -> GCCGAACTGGCATGCTGCA
AGCCGAATTACTAAAAGTC -> GCCGAATTACTAAAAGTCC
AGCCGCCCAAACATAGGAC -> GCCGCCCAAACATAGGACC
AGCCGCGTCTCCTGGCGGG -> GCCGCGTCTCCTGGCGGGT
AGCCGCTTCGTGCACGCGG -> GCCGCTTCGTGCACGCGGC
AGCCGGTTTACCCTGGCCT -> GCCGGTTTACCCTGGCCTA
AGCCTAGCATCAGCAGAGG -> GCCTAGCATCAGCAGAGGG
AGCGAAAGCGGCTCATGTG -> GCGAAAGCGGCTCATGTGA
AGCGAGACGTACAAGTCGC -> GCGAGACGTACAAGTCGCA
AGCGCACCAAGCCGAACTG -> GCGCACCAAGCCGAACTGG
AGCGCCAATTAAGATAAGT -> GCGCCAATTAAGATAAGTC
AGCGGCAGATTGAGTGAAG -> GCGGCAGATTGAGTGAAGA
AGCGGCCCAGCATCTTTGG -> GCGGCCCAGCATCTTTGGC
AGCGGCTCATGTGAAGGAT -> GCGGCTCATGTGAAGGATC
AGCGGGCAATCTGCTTGGA -> GCGGGCAATCTGCTTGGAC
AGCGTTAGAACGCAGACGT -> GCGTTAGAACGCAGACGTG
AGCGTTGCCTTACGTATTT -> GCGTTGCCTTACGTATTTC
AGCTATGCTTGAGCTCAAA -> GCTATGCTTGAGCTCAAAG
AGCTATGTCTGTGGTCTCG -> GCTATGTCTGTGGTCTCGC
AGCTCAAAGAAGCGTTGCC -> GCTCAAAGAAGCGTTGCCT
AGCTCAGGTGTCAAAATGC -> GCTCAGGTGTCAAAATGCT
AGCTCTTGCTGTCTCGCTG -> GCTCTTGCTGTCTCGCTGG
AGCTGGTGTCGGCAATTCT -> GCTGGTGTCGGCAATTCTA
AGCTGTAGATGATCATGTA -> GCTGTAGATGATCATGTAG
AGCTGTGAGATCGGTATTG -> GCTGTGAGATCGGTATTGT
AGCTGTTGAAGCACCATAG -> GCTGTTGAAGCACCATAGT
AGCTTACGTCAGCAGGATA -> GCTTACGTCAGCAGGATAC
AGCTTATCGAGTCGGGAGG -> GCTTATCGAGTCGGGAGGG
AGGAACGACCAGCCGGTTT -> GGAACGACCAGCCGGTTTA
AGGAAGCGCCAATTAAGAT -> GGAAGCGCCAATTAAGATA
AGGAATATATTCCACTGGA -> GGAATATATTCCACTGGAG
AGGACCGCGGCTAAAATAC -> GGACCGCGGCTAAAATACC
AGGATACCAAACAGTCGAC -> GGATACCAAACAGTCGACT
AGGATAGCTATGCTTGAGC -> GGATAGCTATGCTTGAGCT
AGGATCGAGGGGACCAGCC -> GGATCGAGGGGACCAGCCG
AGGCACCTCAGGAATATAT -> GGCACCTCAGGAATATATT
AGGCAGGATAGCTATGCTT -> GGCAGGATAGCTATGCTTG
AGGCCCCGTAGTACCCAAT -> GGCCCCGTAGTACCCAATC
AGGCCTGACGGGCGTTCGT -> GGCCTGACGGGCGTTCGTG
AGGCGAGGTTGTAAATCGC -> GGCGAGGTTGTAAATCGCG
AGGCGCGCGTCAGAGAAGT -> GGCGCGCGTCAGAGAAGTG
AGGCTCCAGAGAATACTTC -> GGCTCCAGAGAATACTTCG
AGGCTTATCGAGTCGGGAG -> GGCTTATCGAGTCGGGAGG
AGGGAATCAGGCCTGACGG -> GGGAATCAGGCCTGACGGG
AGGGCAACAGTAATGACAT -> GGGCAACAGTAATGACATA
AGGGCCCAGTCTCGCGCGC -> GGGCCCAGTCTCGCGCGCT
AGGGCGTGGAGAGTCCAAG -> GGGCGTGGAGAGTCCAAGT
AGGGCTACGCGCTGCTCCT -> GGGCTACGCGCTGCTCCTT
AGGGCTAGACGGACGCTCC -> GGGCTAGACGGACGCTCCT
AGGGGACCAGCCGCTTCGT -> GGGGACCAGCCGCTTCGTG
AGGGGTGAGATCGTTACTC -> GGGGTGAGATCGTTACTCA
AGGTAAGTGTGGGGCCTAT -> GGTAAGTGTGGGGCCTATC
AGGTCGTCTCCGGGGACCC -> GGTCGTCTCCGGGGACCCT
AGGTCTCGCCTGCTGGCCC -> GGTCTCGCCTGCTGGCCCG
AGGTGGTTCTGACAGTATG -> GGTGGTTCTGACAGTATGC
AGGTGTCAAAATGCTGCTC -> GGTGTCAAAATGCTGCTCG
AGGTTCAACCTGTAATCTT -> GGTTCAACCTGTAATCTTC
AGGTTGAGGTAAGTGTGGG -> GGTTGAGGTAAGTGTGGGG
AGGTTGTAAATCGCGTGCC -> GGTTGTAAATCGCGTGCCA
AGTAATGACATATCGAACT -> GTAATGACATATCGAACTA
AGTACATCCGTTAGCGCAC -> GTACATCCGTTAGCGCACC
AGTACCCAATCATGCGGCG -> GTACCCAATCATGCGGCGC
AGTACGTGGATGTTCGAGA -> GTACGTGGATGTTCGAGAT
AGTAGGTTCAACCTGTAAT -> GTAGGTTCAACCTGTAATC
AGTATGCCACTCATGGCCT -> GTATGCCACTCATGGCCTT
AGTCCAAGTGCGAAGACGA -> GTCCAAGTGCGAAGACGAC
AGTCCATTTTGAGACGAAG -> GTCCATTTTGAGACGAAGG
AGTCCTCAGCACTATATGA -> GTCCTCAGCACTATATGAT
AGTCGACCGCCTCCGGTCT -> GTCGACCGCCTCCGGTCTC
AGTCGACTCGCGTGAACGC -> GTCGACTCGCGTGAACGCA
AGTCGCAGGTCTCGCCTGC -> GTCGCAGGTCTCGCCTGCT
AGTCGGGAGGGCAACAGTA -> GTCGGGAGGGCAACAGTAA
AGTCGGGAGGGCCCAGTCT -> GTCGGGAGGGCCCAGTCTC
AGTCGGGAGGGCTACGCGC -> GTCGGGAGGGCTACGCGCT
AGTCGGGAGGGCTAGACGG -> GTCGGGAGGGCTAGACGGA
AGTCGTAACATTGGCTACG -> GTCGTAACATTGGCTACGT
AGTCTCGCGCGCTAATCAT -> GTCTCGCGCGCTAATCATG
AGTCTCGTGGAGCCTAGCA -> GTCTCGTGGAGCCTAGCAT
AGTCTTGCTTAATGGGGTT -> GTCTTGCTTAATGGGGTTC
AGTGAAGAAAGACTATGTA -> GTGAAGAAAGACTATGTAC
AGTGACCCATAATTGTCAG -> GTGACCCATAATTGTCAGC
AGTGACCCCTACCATCTAC -> GTGACCCCTACCATCTACC
AGTGACCCGTACCGAGAGG -> GTGACCCGTACCGAGAGGC
AGTGACCCTTGCTAAACAT -> GTGACCCTTGCTAAACATC
AGTGATTGGAGGGCGTGGA -> GTGATTGGAGGGCGTGGAG
AGTGCGAAGACGACGCCAT -> GTGCGAAGACGACGCCATG
AGTGGGTAGTCCATTTTGA -> GTGGGTAGTCCATTTTGAG
AGTGTGGGGCCTATCATTG -> GTGTGGGGCCTATCATTGA
AGTTCGCTTTAATCACAAG -> GTTCGCTTTAATCACAAGT
AGTTGTCATCCAAGACTGT -> GTTGTCATCCAAGACTGTC
ATAACTTTCAATTGATGGA -> TAACTTTCAATTGATGGAA
ATAAGTCGTAACATTGGCT -> TAAGTCGTAACATTGGCTA
ATAATGGGAAAAACCAAAG -> TAATGGGAAAAACCAAAGG
ATAATTGTCAGCTTATCGA -> TAATTGTCAGCTTATCGAG
ATACAACGTCCATAGAGCT -> TACAACGTCCATAGAGCTG
ATACAATATTGATCGGTGT -> TACAATATTGATCGGTGTA
ATACATACAACGTCCATAG -> TACATACAACGTCCATAGA
ATACCAAACAGTCGACTCG -> TACCAAACAGTCGACTCGC
ATACCGCGTGGTAGAGTAG -> TACCGCGTGGTAGAGTAGG
ATACCTACCACATACGCGT -> TACCTACCACATACGCGTA
ATACCTGTCAAAGTCTCGT -> TACCTGTCAAAGTCTCGTG
ATACGCGTATTCGGGCCCC -> TACGCGTATTCGGGCCCCC
ATACGTTTTGCTCAGCTCA -> TACGTTTTGCTCAGCTCAG
ATACTGACCGAGATCCGGC -> TACTGACCGAGATCCGGCG
ATACTTCGGGGGCTTTTTT -> TACTTCGGGGGCTTTTTTG
ATAGACGCTCTGCAGTGAC -> TAGACGCTCTGCAGTGACC
ATAGACTGCATGTTCCCCG -> TAGACTGCATGTTCCCCGG
ATAGAGCTGTGAGATCGGT -> TAGAGCTGTGAGATCGGTA
ATAGATGCATTTGGGAAGA -> TAGATGCATTTGGGAAGAC
ATAGCTATGCTTGAGCTCA -> TAGCTATGCTTGAGCTCAA
ATAGCTATGTCTGTGGTCT -> TAGCTATGTCTGTGGTCTC
ATAGGACCGCGGCTAAAAT -> TAGGACCGCGGCTAAAATA
ATAGTTCGCTTTAATCACA -> TAGTTCGCTTTAATCACAA
ATAGTTGTCATCCAAGACT -> TAGTTGTCATCCAAGACTG
ATATACAATATTGATCGGT -> TATACAATATTGATCGGTG
ATATATGCCCCCTATTGTT -> TATATGCCCCCTATTGTTG
ATATATTCCACTGGAGCCG -> TATATTCCACTGGAGCCGC
ATATCCGAAGCTCTTGCTG -> TATCCGAAGCTCTTGCTGT
ATATCGAACTAACAGATAA -> TATCGAACTAACAGATAAC
ATATGATCTCCCAAATCTA -> TATGATCTCCCAAATCTAC
ATATGCCCCCTATTGTTGT -> TATGCCCCCTATTGTTGTC
ATATTACCCAACGCTAGAG -> TATTACCCAACGCTAGAGG
ATATTCCACTGGAGCCGCC -> TATTCCACTGGAGCCGCCC
ATATTGATCGGTGTAACCC -> TATTGATCGGTGTAACCCA
ATCACAAGGCACCTCAGGA -> TCACAAGGCACCTCAGGAA
ATCACAAGTCTTGCTTAAT -> TCACAAGTCTTGCTTAATG
ATCACATCTACTGAAGATT -> TCACATCTACTGAAGATTA
ATCACGTGGTACTAATGAG -> TCACGTGGTACTAATGAGA
ATCAGCAGAGGGAATCAGG -> TCAGCAGAGGGAATCAGGC
ATCAGGCCTGACGGGCGTT -> TCAGGCCTGACGGGCGTTC
ATCAGGTTGAGGTAAGTGT -> TCAGGTTGAGGTAAGTGTG
ATCATGAAATACTGACCGA -> TCATGAAATACTGACCGAG
ATCATGCGGCGCATTCCAA -> TCATGCGGCGCATTCCAAA
ATCATGTAGATTTAACCGC -> TCATGTAGATTTAACCGCA
ATCATTGATACCGCGTGGT -> TCATTGATACCGCGTGGTA
ATCCAAGACTGTCCTGATT -> TCCAAGACTGTCCTGATTA
ATCCCGCCTCTCACGGCTA -> TCCCGCCTCTCACGGCTAA
ATCCGAAGCTCTTGCTGTC -> TCCGAAGCTCTTGCTGTCT
ATCCGGCGAATACCTGTCA -> TCCGGCGAATACCTGTCAA
ATCCGTTAGCGCACCAAGC -> TCCGTTAGCGCACCAAGCC
ATCCTACTGATTTCTAAAT -> TCCTACTGATTTCTAAATG
ATCGAAAATTCCCAGGTCG -> TCGAAAATTCCCAGGTCGT
ATCGAACTAACAGATAACT -> TCGAACTAACAGATAACTT
ATCGAGGGGACCAGCCGCT -> TCGAGGGGACCAGCCGCTT
ATCGAGTCGGGAGGGCAAC -> TCGAGTCGGGAGGGCAACA
ATCGAGTCGGGAGGGCCCA -> TCGAGTCGGGAGGGCCCAG
ATCGAGTCGGGAGGGCTAC -> TCGAGTCGGGAGGGCTACG
ATCGAGTCGGGAGGGCTAG -> TCGAGTCGGGAGGGCTAGA
ATCGCGTGCCACAGAGCGG -> TCGCGTGCCACAGAGCGGG
ATCGGTATTGTGCTCTATC -> TCGGTATTGTGCTCTATCA
ATCGGTGTAACCCACAAAG -> TCGGTGTAACCCACAAAGT
ATCGTTACTCACGCACCCG -> TCGTTACTCACGCACCCGA
ATCTACAGGCCCCGTAGTA -> TCTACAGGCCCCGTAGTAC
ATCTACCTTATCGAGTCGG -> TCTACCTTATCGAGTCGGG
ATCTACTGAAGATTAGCCC -> TCTACTGAAGATTAGCCCC
ATCTAGCTGTTGAAGCACC -> TCTAGCTGTTGAAGCACCA
ATCTCCCAAATCTACAGGC -> TCTCCCAAATCTACAGGCC
ATCTGAGCTGTAGATGATC -> TCTGAGCTGTAGATGATCA
ATCTGCTTGGACGCTCTGC -> TCTGCTTGGACGCTCTGCA
ATCTTATCGAGTCGGGAGG -> TCTTATCGAGTCGGGAGGG
ATCTTCAGCAAATGATATA -> TCTTCAGCAAATGATATAT
ATCTTTGGCGTAGCGAAAG -> TCTTTGGCGTAGCGAAAGC
ATCTTTGTCGTGACGAGTA -> TCTTTGTCGTGACGAGTAC
ATGAAATACTGACCGAGAT -> TGAAATACTGACCGAGATC
ATGAACATAGCTATGTCTG -> TGAACATAGCTATGTCTGT
ATGACATATCGAACTAACA -> TGACATATCGAACTAACAG
ATGACGAGCCGAATTACTA -> TGACGAGCCGAATTACTAA
ATGAGACCTGAGCAAAAGC -> TGAGACCTGAGCAAAAGCA
ATGATAGACTGCATGTTCC -> TGATAGACTGCATGTTCCC
ATGATATATGCCCCCTATT -> TGATATATGCCCCCTATTG
ATGATCATGTAGATTTAAC -> TGATCATGTAGATTTAACC
ATGATCTCCCAAATCTACA -> TGATCTCCCAAATCTACAG
ATGATTCGTTCAGCGTTAG -> TGATTCGTTCAGCGTTAGA
ATGCATTTGGGAAGACTAT -> TGCATTTGGGAAGACTATC
ATGCCACTCATGGCCTTCG -> TGCCACTCATGGCCTTCGG
ATGCCCCCTATTGTTGTCT -> TGCCCCCTATTGTTGTCTT
ATGCGGCGCATTCCAAATC -> TGCGGCGCATTCCAAATCA
ATGCTGCACAAACTTGGAT -> TGCTGCACAAACTTGGATT
ATGCTGCTCGTACGAACAA -> TGCTGCTCGTACGAACAAT
ATGCTTGAGCTCAAAGAAG -> TGCTTGAGCTCAAAGAAGC
ATGGAAGCTTACGTCAGCA -> TGGAAGCTTACGTCAGCAG
ATGGATCTTTGTCGTGACG -> TGGATCTTTGTCGTGACGA
ATGGATTTCGATGGTCACT -> TGGATTTCGATGGTCACTG
ATGGCCTTCGGCTACTATC -> TGGCCTTCGGCTACTATCT
ATGGGAAAAACCAAAGGAA -> TGGGAAAAACCAAAGGAAC
ATGGGGTTCTAGCGGCCCA -> TGGGGTTCTAGCGGCCCAG
ATGGTCACTGCGGGAATCG -> TGGTCACTGCGGGAATCGG
ATGTACCAACGTACTTGTG -> TGTACCAACGTACTTGTGA
ATGTAGATTTAACCGCACG -> TGTAGATTTAACCGCACGG
ATGTCTGTGGTCTCGCCGT -> TGTCTGTGGTCTCGCCGTA
ATGTGAAGGATCGAGGGGA -> TGTGAAGGATCGAGGGGAC
ATGTTCCCCGGGCTTAACA -> TGTTCCCCGGGCTTAACAG
ATGTTCGAGATACATACAA -> TGTTCGAGATACATACAAC
ATTAAGATAAGTCGTAACA -> TTAAGATAAGTCGTAACAT
ATTACCCAACGCTAGAGGA -> TTACCCAACGCTAGAGGAA
ATTACTAAAAGTCCTCAGC -> TTACTAAAAGTCCTCAGCA
ATTAGCACTCACAGCGAGA -> TTAGCACTCACAGCGAGAC
ATTAGCCCCCTCTGGTTCC -> TTAGCCCCCTCTGGTTCCT
ATTAGGCTCCAGAGAATAC -> TTAGGCTCCAGAGAATACT
ATTATTTATAGATGCATTT -> TTATTTATAGATGCATTTG
ATTCCAAATCACAAGGCAC -> TTCCAAATCACAAGGCACC
ATTCCACTGGAGCCGCCCA -> TTCCACTGGAGCCGCCCAA
ATTCCCAGGTCGTCTCCGG -> TTCCCAGGTCGTCTCCGGG
ATTCCCTTTGTGCTGGAAA -> TTCCCTTTGTGCTGGAAAA
ATTCGGGCCCCCTGAGAGA -> TTCGGGCCCCCTGAGAGAG
ATTCGTTCAGCGTTAGAAC -> TTCGTTCAGCGTTAGAACG
ATTCTATATCCGAAGCTCT -> TTCTATATCCGAAGCTCTT
ATTGAGTGAAGAAAGACTA -> TTGAGTGAAGAAAGACTAT
ATTGATACCGCGTGGTAGA -> TTGATACCGCGTGGTAGAG
ATTGATCGGTGTAACCCAC -> TTGATCGGTGTAACCCACA
ATTGATGGAAGCTTACGTC -> TTGATGGAAGCTTACGTCA
ATTGGAGGGCGTGGAGAGT -> TTGGAGGGCGTGGAGAGTC
ATTGGCTACGTCCCGACGT -> TTGGCTACGTCCCGACGTC
ATTGTCAGCTTATCGAGTC -> TTGTCAGCTTATCGAGTCG
ATTGTCTTCAGAACCCGAT -> TTGTCTTCAGAACCCGATC
ATTGTGCTCTATCAGGTTG -> TTGTGCTCTATCAGGTTGA
ATTGTTGTCTTCATGATTC -> TTGTTGTCTTCATGATTCG
ATTTAACCGCACGGATGAT -> TTTAACCGCACGGATGATA
ATTTATAGATGCATTTGGG -> TTTATAGATGCATTTGGGA
ATTTCGACGCTCTGCAGTG -> TTTCGACGCTCTGCAGTGA
ATTTCGATGGTCACTGCGG -> TTTCGATGGTCACTGCGGG
ATTTCTAAATGACGAGCCG -> TTTCTAAATGACGAGCCGA
ATTTGGGAAGACTATCACG -> TTTGGGAAGACTATCACGT
ATTTTGAGACGAAGGTGGT -> TTTTGAGACGAAGGTGGTT
CAAAAGCAGCGGCAGATTG -> AAAAGCAGCGGCAGATTGA
CAAAATGCTGCTCGTACGA -> AAAATGCTGCTCGTACGAA
CAAACAGTCGACTCGCGTG -> AAACAGTCGACTCGCGTGA
CAAACATAGGACCGCGGCT -> AAACATAGGACCGCGGCTA
CAAACTTGGATTCCCTTTG -> AAACTTGGATTCCCTTTGT
CAAAGAAGCGTTGCCTTAC -> AAAGAAGCGTTGCCTTACG
CAAAGGAACGACCAGCCGG -> AAAGGAACGACCAGCCGGT
CAAAGTACATCCGTTAGCG -> AAAGTACATCCGTTAGCGC
CAAAGTCTCGTGGAGCCTA -> AAAGTCTCGTGGAGCCTAG
CAAATCACAAGGCACCTCA -> AAATCACAAGGCACCTCAG
CAAATCTACAGGCCCCGTA -> AAATCTACAGGCCCCGTAG
CAAATGATATATGCCCCCT -> AAATGATATATGCCCCCTA
CAACAGTAATGACATATCG -> AACAGTAATGACATATCGA
CAACCAATATTACCCAACG -> AACCAATATTACCCAACGC
CAACCTGTAATCTTCAGCA -> AACCTGTAATCTTCAGCAA
CAACGCTAGAGGAAGCGCC -> AACGCTAGAGGAAGCGCCA
CAACGTACTTGTGACGCTC -> AACGTACTTGTGACGCTCT
CAACGTCCATAGAGCTGTG -> AACGTCCATAGAGCTGTGA
CAAGACTGTCCTGATTATT -> AAGACTGTCCTGATTATTT
CAAGCCGAACTGGCATGCT -> AAGCCGAACTGGCATGCTG
CAAGGCACCTCAGGAATAT -> AAGGCACCTCAGGAATATA
CAAGGGGTGAGATCGTTAC -> AAGGGGTGAGATCGTTACT
CAAGTCGCAGGTCTCGCCT -> AAGTCGCAGGTCTCGCCTG
CAAGTCTTGCTTAATGGGG -> AAGTCTTGCTTAATGGGGT
CAAGTGCGAAGACGACGCC -> AAGTGCGAAGACGACGCCA
CAATATTACCCAACGCTAG -> AATATTACCCAACGCTAGA
CAATATTGATCGGTGTAAC -> AATATTGATCGGTGTAACC
CAATCACATCTACTGAAGA -> AATCACATCTACTGAAGAT
CAATCATGCGGCGCATTCC -> AATCATGCGGCGCATTCCA
CAATCTGCTTGGACGCTCT -> AATCTGCTTGGACGCTCTG
CAATTAAGATAAGTCGTAA -> AATTAAGATAAGTCGTAAC
CAATTCTATATCCGAAGCT -> AATTCTATATCCGAAGCTC
CAATTGATGGAAGCTTACG -> AATTGATGGAAGCTTACGT
CACAAACTTGGATTCCCTT -> ACAAACTTGGATTCCCTTT
CACAAAGTACATCCGTTAG -> ACAAAGTACATCCGTTAGC
CACAAGGCACCTCAGGAAT -> ACAAGGCACCTCAGGAATA
CACAAGTCTTGCTTAATGG -> ACAAGTCTTGCTTAATGGG
CACAGAGCGGGCAATCTGC -> ACAGAGCGGGCAATCTGCT
CACAGCGAGACGTACAAGT -> ACAGCGAGACGTACAAGTC
CACAGTGATTGGAGGGCGT -> ACAGTGATTGGAGGGCGTG
CACATACGCGTATTCGGGC -> ACATACGCGTATTCGGGCC
CACATCTACTGAAGATTAG -> ACATCTACTGAAGATTAGC
CACCAAGCCGAACTGGCAT -> ACCAAGCCGAACTGGCATG
CACCATAGTTGTCATCCAA -> ACCATAGTTGTCATCCAAG
CACCCGACAGTCGACCGCC -> ACCCGACAGTCGACCGCCT
CACCTCAGGAATATATTCC -> ACCTCAGGAATATATTCCA
CACGCACCCGACAGTCGAC -> ACGCACCCGACAGTCGACC
CACGCGGCTCTGGTATATA -> ACGCGGCTCTGGTATATAC
CACGGATGATAGACTGCAT -> ACGGATGATAGACTGCATG
CACGGCTAAGCTGGTGTCG -> ACGGCTAAGCTGGTGTCGG
CACGGTCGTCGTAACCCCT -> ACGGTCGTCGTAACCCCTC
CACGTATTAGCACTCACAG -> ACGTATTAGCACTCACAGC
CACGTGAAATCTAGCTGTT -> ACGTGAAATCTAGCTGTTG
CACGTGGTACTAATGAGAC -> ACGTGGTACTAATGAGACC
CACTATATGATCTCCCAAA -> ACTATATGATCTCCCAAAT
CACTCACAGCGAGACGTAC -> ACTCACAGCGAGACGTACA
CACTCATGGCCTTCGGCTA -> ACTCATGGCCTTCGGCTAC
CACTCCGGCCTAACGATTG -> ACTCCGGCCTAACGATTGT
CACTGACCACGGTCGTCGT -> ACTGACCACGGTCGTCGTA
CACTGACTGAAGATAGTTC -> ACTGACTGAAGATAGTTCG
CACTGCGGGAATCGGTAGG -> ACTGCGGGAATCGGTAGGG
CACTGGAGCCGCCCAAACA -> ACTGGAGCCGCCCAAACAT
CAGAACCCGATCCTACTGA -> AGAACCCGATCCTACTGAT
CAGACGTGCTAGATACGTT -> AGACGTGCTAGATACGTTT
CAGAGAAGTGGGTAGTCCA -> AGAGAAGTGGGTAGTCCAT
CAGAGAATACTTCGGGGGC -> AGAGAATACTTCGGGGGCT
CAGAGCCGCGTCTCCTGGC -> AGAGCCGCGTCTCCTGGCG
CAGAGCGGGCAATCTGCTT -> AGAGCGGGCAATCTGCTTG
CAGAGGGAATCAGGCCTGA -> AGAGGGAATCAGGCCTGAC
CAGATAACTTTCAATTGAT -> AGATAACTTTCAATTGATG
CAGATTGAGTGAAGAAAGA -> AGATTGAGTGAAGAAAGAC
CAGCAAATGATATATGCCC -> AGCAAATGATATATGCCCC
CAGCACTATATGATCTCCC -> AGCACTATATGATCTCCCA
CAGCAGAGGGAATCAGGCC -> AGCAGAGGGAATCAGGCCT
CAGCAGGATACCAAACAGT -> AGCAGGATACCAAACAGTC
CAGCATCTTTGGCGTAGCG -> AGCATCTTTGGCGTAGCGA
CAGCCCGTCTTCTATTAGG -> AGCCCGTCTTCTATTAGGC
CAGCCGCTTCGTGCACGCG -> AGCCGCTTCGTGCACGCGG
CAGCCGGTTTACCCTGGCC -> AGCCGGTTTACCCTGGCCT
CAGCGAGACGTACAAGTCG -> AGCGAGACGTACAAGTCGC
CAGCGGCAGATTGAGTGAA -> AGCGGCAGATTGAGTGAAG
CAGCGTTAGAACGCAGACG -> AGCGTTAGAACGCAGACGT
CAGCTCAGGTGTCAAAATG -> AGCTCAGGTGTCAAAATGC
CAGCTTATCGAGTCGGGAG -> AGCTTATCGAGTCGGGAGG
CAGGAATATATTCCACTGG -> AGGAATATATTCCACTGGA
CAGGATACCAAACAGTCGA -> AGGATACCAAACAGTCGAC
CAGGATAGCTATGCTTGAG -> AGGATAGCTATGCTTGAGC
CAGGCAGGATAGCTATGCT -> AGGCAGGATAGCTATGCTT
CAGGCCCCGTAGTACCCAA -> AGGCCCCGTAGTACCCAAT
CAGGCCTGACGGGCGTTCG -> AGGCCTGACGGGCGTTCGT
CAGGCGAGGTTGTAAATCG -> AGGCGAGGTTGTAAATCGC
CAGGCGCGCGTCAGAGAAG -> AGGCGCGCGTCAGAGAAGT
CAGGTCGTCTCCGGGGACC -> AGGTCGTCTCCGGGGACCC
CAGGTCTCGCCTGCTGGCC -> AGGTCTCGCCTGCTGGCCC
CAGGTGTCAAAATGCTGCT -> AGGTGTCAAAATGCTGCTC
CAGGTTGAGGTAAGTGTGG -> AGGTTGAGGTAAGTGTGGG
CAGTAATGACATATCGAAC -> AGTAATGACATATCGAACT
CAGTATGCCACTCATGGCC -> AGTATGCCACTCATGGCCT
CAGTCGACCGCCTCCGGTC -> AGTCGACCGCCTCCGGTCT
CAGTCGACTCGCGTGAACG -> AGTCGACTCGCGTGAACGC
CAGTCTCGCGCGCTAATCA -> AGTCTCGCGCGCTAATCAT
CAGTGACCCATAATTGTCA -> AGTGACCCATAATTGTCAG
CAGTGACCCCTACCATCTA -> AGTGACCCCTACCATCTAC
CAGTGACCCGTACCGAGAG -> AGTGACCCGTACCGAGAGG
CAGTGACCCTTGCTAAACA -> AGTGACCCTTGCTAAACAT
CAGTGATTGGAGGGCGTGG -> AGTGATTGGAGGGCGTGGA
CATAATGGGAAAAACCAAA -> ATAATGGGAAAAACCAAAG
CATAATTGTCAGCTTATCG -> ATAATTGTCAGCTTATCGA
CATACAACGTCCATAGAGC -> ATACAACGTCCATAGAGCT
CATACGCGTATTCGGGCCC -> ATACGCGTATTCGGGCCCC
CATAGAGCTGTGAGATCGG -> ATAGAGCTGTGAGATCGGT
CATAGCTATGTCTGTGGTC -> ATAGCTATGTCTGTGGTCT
CATAGGACCGCGGCTAAAA -> ATAGGACCGCGGCTAAAAT
CATAGTTGTCATCCAAGAC -> ATAGTTGTCATCCAAGACT
CATATCGAACTAACAGATA -> ATATCGAACTAACAGATAA
CATCAGCAGAGGGAATCAG -> ATCAGCAGAGGGAATCAGG
CATCCAAGACTGTCCTGAT -> ATCCAAGACTGTCCTGATT
CATCCGTTAGCGCACCAAG -> ATCCGTTAGCGCACCAAGC
CATCGAAAATTCCCAGGTC -> ATCGAAAATTCCCAGGTCG
CATCTACCTTATCGAGTCG -> ATCTACCTTATCGAGTCGG
CATCTACTGAAGATTAGCC -> ATCTACTGAAGATTAGCCC
CATCTTATCGAGTCGGGAG -> ATCTTATCGAGTCGGGAGG
CATCTTTGGCGTAGCGAAA -> ATCTTTGGCGTAGCGAAAG
CATGAAATACTGACCGAGA -> ATGAAATACTGACCGAGAT
CATGATTCGTTCAGCGTTA -> ATGATTCGTTCAGCGTTAG
CATGCGGCGCATTCCAAAT -> ATGCGGCGCATTCCAAATC
CATGCTGCACAAACTTGGA -> ATGCTGCACAAACTTGGAT
CATGGATCTTTGTCGTGAC -> ATGGATCTTTGTCGTGACG
CATGGCCTTCGGCTACTAT -> ATGGCCTTCGGCTACTATC
CATGTAGATTTAACCGCAC -> ATGTAGATTTAACCGCACG
CATGTGAAGGATCGAGGGG -> ATGTGAAGGATCGAGGGGA
CATGTTCCCCGGGCTTAAC -> ATGTTCCCCGGGCTTAACA
CATTCCAAATCACAAGGCA -> ATTCCAAATCACAAGGCAC
CATTGATACCGCGTGGTAG -> ATTGATACCGCGTGGTAGA
CATTGGCTACGTCCCGACG -> ATTGGCTACGTCCCGACGT
CATTTGGGAAGACTATCAC -> ATTTGGGAAGACTATCACG
CATTTTGAGACGAAGGTGG -> ATTTTGAGACGAAGGTGGT
CCAAACAGTCGACTCGCGT -> CAAACAGTCGACTCGCGTG
CCAAACATAGGACCGCGGC -> CAAACATAGGACCGCGGCT
CCAAAGGAACGACCAGCCG -> CAAAGGAACGACCAGCCGG
CCAAATCACAAGGCACCTC -> CAAATCACAAGGCACCTCA
CCAAATCTACAGGCCCCGT -> CAAATCTACAGGCCCCGTA
CCAACGCTAGAGGAAGCGC -> CAACGCTAGAGGAAGCGCC
CCAACGTACTTGTGACGCT -> CAACGTACTTGTGACGCTC
CCAAGACTGTCCTGATTAT -> CAAGACTGTCCTGATTATT
CCAAGCCGAACTGGCATGC -> CAAGCCGAACTGGCATGCT
CCAAGTGCGAAGACGACGC -> CAAGTGCGAAGACGACGCC
CCAATATTACCCAACGCTA -> CAATATTACCCAACGCTAG
CCAATCATGCGGCGCATTC -> CAATCATGCGGCGCATTCC
CCAATTAAGATAAGTCGTA -> CAATTAAGATAAGTCGTAA
CCACAAAGTACATCCGTTA -> CACAAAGTACATCCGTTAG
CCACAGAGCGGGCAATCTG -> CACAGAGCGGGCAATCTGC
CCACATACGCGTATTCGGG -> CACATACGCGTATTCGGGC
CCACGGTCGTCGTAACCCC -> CACGGTCGTCGTAACCCCT
CCACTCATGGCCTTCGGCT -> CACTCATGGCCTTCGGCTA
CCACTGACTGAAGATAGTT -> CACTGACTGAAGATAGTTC
CCACTGGAGCCGCCCAAAC -> CACTGGAGCCGCCCAAACA
CCAGAGAATACTTCGGGGG -> CAGAGAATACTTCGGGGGC
CCAGCATCTTTGGCGTAGC -> CAGCATCTTTGGCGTAGCG
CCAGCCGCTTCGTGCACGC -> CAGCCGCTTCGTGCACGCG
CCAGCCGGTTTACCCTGGC -> CAGCCGGTTTACCCTGGCC
CCAGGCGAGGTTGTAAATC -> CAGGCGAGGTTGTAAATCG
CCAGGTCGTCTCCGGGGAC -> CAGGTCGTCTCCGGGGACC
CCAGTCTCGCGCGCTAATC -> CAGTCTCGCGCGCTAATCA
CCATAATTGTCAGCTTATC -> CATAATTGTCAGCTTATCG
CCATAGAGCTGTGAGATCG -> CATAGAGCTGTGAGATCGG
CCATAGTTGTCATCCAAGA -> CATAGTTGTCATCCAAGAC
CCATCGAAAATTCCCAGGT -> CATCGAAAATTCCCAGGTC
CCATCTACCTTATCGAGTC -> CATCTACCTTATCGAGTCG
CCATGGATCTTTGTCGTGA -> CATGGATCTTTGTCGTGAC
CCATTTTGAGACGAAGGTG -> CATTTTGAGACGAAGGTGG
CCCAAACATAGGACCGCGG -> CCAAACATAGGACCGCGGC
CCCAAATCTACAGGCCCCG -> CCAAATCTACAGGCCCCGT
CCCAACGCTAGAGGAAGCG -> CCAACGCTAGAGGAAGCGC
CCCAATCATGCGGCGCATT -> CCAATCATGCGGCGCATTC
CCCACAAAGTACATCCGTT -> CCACAAAGTACATCCGTTA
CCCAGCATCTTTGGCGTAG -> CCAGCATCTTTGGCGTAGC
CCCAGGTCGTCTCCGGGGA -> CCAGGTCGTCTCCGGGGAC
CCCAGTCTCGCGCGCTAAT -> CCAGTCTCGCGCGCTAATC
CCCATAATTGTCAGCTTAT -> CCATAATTGTCAGCTTATC
CCCATCGAAAATTCCCAGG -> CCATCGAAAATTCCCAGGT
CCCCATCGAAAATTCCCAG -> CCCATCGAAAATTCCCAGG
CCCCCTATTGTTGTCTTCA -> CCCCTATTGTTGTCTTCAT
CCCCCTCTGGTTCCTACAG -> CCCCTCTGGTTCCTACAGG
CCCCCTGAGAGAGCATAAT -> CCCCTGAGAGAGCATAATG
CCCCGGGCTTAACAGAGCC -> CCCGGGCTTAACAGAGCCG
CCCCGTAGTACCCAATCAT -> CCCGTAGTACCCAATCATG
CCCCTACCATCTACCTTAT -> CCCTACCATCTACCTTATC
CCCCTATTGTTGTCTTCAT -> CCCTATTGTTGTCTTCATG
CCCCTCCCGCAACCAATAT -> CCCTCCCGCAACCAATATT
CCCCTCTGGTTCCTACAGG -> CCCTCTGGTTCCTACAGGC
CCCCTGAGAGAGCATAATG -> CCCTGAGAGAGCATAATGG
CCCGACAAGGGGTGAGATC -> CCGACAAGGGGTGAGATCG
CCCGACAGTCGACCGCCTC -> CCGACAGTCGACCGCCTCC
CCCGACGTCCCGCGTCCGC -> CCGACGTCCCGCGTCCGCA
CCCGATCCTACTGATTTCT -> CCGATCCTACTGATTTCTA
CCCGCAACCAATATTACCC -> CCGCAACCAATATTACCCA
CCCGCCTCTCACGGCTAAG -> CCGCCTCTCACGGCTAAGC
CCCGCGTCCGCAGCCCGTC -> CCGCGTCCGCAGCCCGTCT
CCCGGGCTTAACAGAGCCG -> CCGGGCTTAACAGAGCCGC
CCCGTACCGAGAGGCTTAT -> CCGTACCGAGAGGCTTATC
CCCGTAGTACCCAATCATG -> CCGTAGTACCCAATCATGC
CCCGTCTTCTATTAGGCTC -> CCGTCTTCTATTAGGCTCC
CCCTACCATCTACCTTATC -> CCTACCATCTACCTTATCG
CCCTACTCCGATGGATTTC -> CCTACTCCGATGGATTTCG
CCCTATTGTTGTCTTCATG -> CCTATTGTTGTCTTCATGA
CCCTCCCGCAACCAATATT -> CCTCCCGCAACCAATATTA
CCCTCTGGTTCCTACAGGC -> CCTCTGGTTCCTACAGGCG
CCCTGAGAGAGCATAATGG -> CCTGAGAGAGCATAATGGG
CCCTGGCCTAAACTTTCCA -> CCTGGCCTAAACTTTCCAG
CCCTTGCTAAACATCTTAT -> CCTTGCTAAACATCTTATC
CCCTTTGTGCTGGAAAACA -> CCTTTGTGCTGGAAAACAC
CCGAACTGGCATGCTGCAC -> CGAACTGGCATGCTGCACA
CCGAAGCTCTTGCTGTCTC -> CGAAGCTCTTGCTGTCTCG
CCGAATTACTAAAAGTCCT -> CGAATTACTAAAAGTCCTC
CCGACAAGGGGTGAGATCG -> CGACAAGGGGTGAGATCGT
CCGACAGTCGACCGCCTCC -> CGACAGTCGACCGCCTCCG
CCGACGTCCCGCGTCCGCA -> CGACGTCCCGCGTCCGCAG
CCGAGAGGCTTATCGAGTC -> CGAGAGGCTTATCGAGTCG
CCGAGATCCGGCGAATACC -> CGAGATCCGGCGAATACCT
CCGATCCTACTGATTTCTA -> CGATCCTACTGATTTCTAA
CCGATGGATTTCGATGGTC -> CGATGGATTTCGATGGTCA
CCGCAACCAATATTACCCA -> CGCAACCAATATTACCCAA
CCGCACGGATGATAGACTG -> CGCACGGATGATAGACTGC
CCGCAGCCCGTCTTCTATT -> CGCAGCCCGTCTTCTATTA
CCGCCCAAACATAGGACCG -> CGCCCAAACATAGGACCGC
CCGCCTCCGGTCTCACTCC -> CGCCTCCGGTCTCACTCCG
CCGCCTCTCACGGCTAAGC -> CGCCTCTCACGGCTAAGCT
CCGCGGCTAAAATACCTAC -> CGCGGCTAAAATACCTACC
CCGCGTCCGCAGCCCGTCT -> CGCGTCCGCAGCCCGTCTT
CCGCGTCTCCTGGCGGGTG -> CGCGTCTCCTGGCGGGTGA
CCGCGTGGTAGAGTAGGTT -> CGCGTGGTAGAGTAGGTTC
CCGCTTCGTGCACGCGGCT -> CGCTTCGTGCACGCGGCTC
CCGGCCTAACGATTGTCTT -> CGGCCTAACGATTGTCTTC
CCGGCGAATACCTGTCAAA -> CGGCGAATACCTGTCAAAG
CCGGGCTTAACAGAGCCGC -> CGGGCTTAACAGAGCCGCG
CCGGGGACCCTACTCCGAT -> CGGGGACCCTACTCCGATG
CCGGTCTCACTCCGGCCTA -> CGGTCTCACTCCGGCCTAA
CCGGTTTACCCTGGCCTAA -> CGGTTTACCCTGGCCTAAA
CCGTACACGTGAAATCTAG -> CGTACACGTGAAATCTAGC
CCGTACCGAGAGGCTTATC -> CGTACCGAGAGGCTTATCG
CCGTAGTACCCAATCATGC -> CGTAGTACCCAATCATGCG
CCGTCTTCTATTAGGCTCC -> CGTCTTCTATTAGGCTCCA
CCGTTAGCGCACCAAGCCG -> CGTTAGCGCACCAAGCCGA
CCTAAACTTTCCAGGCGAG -> CTAAACTTTCCAGGCGAGG
CCTAACGATTGTCTTCAGA -> CTAACGATTGTCTTCAGAA
CCTACAGGCGCGCGTCAGA -> CTACAGGCGCGCGTCAGAG
CCTACCACATACGCGTATT -> CTACCACATACGCGTATTC
CCTACCATCTACCTTATCG -> CTACCATCTACCTTATCGA
CCTACTCCGATGGATTTCG -> CTACTCCGATGGATTTCGA
CCTACTGATTTCTAAATGA -> CTACTGATTTCTAAATGAC
CCTAGCATCAGCAGAGGGA -> CTAGCATCAGCAGAGGGAA
CCTATCATTGATACCGCGT -> CTATCATTGATACCGCGTG
CCTATTGTTGTCTTCATGA -> CTATTGTTGTCTTCATGAT
CCTCAGCACTATATGATCT -> CTCAGCACTATATGATCTC
CCTCAGGAATATATTCCAC -> CTCAGGAATATATTCCACT
CCTCCCCATCGAAAATTCC -> CTCCCCATCGAAAATTCCC
CCTCCCGCAACCAATATTA -> CTCCCGCAACCAATATTAC
CCTCCGGTCTCACTCCGGC -> CTCCGGTCTCACTCCGGCC
CCTCTCACGGCTAAGCTGG -> CTCTCACGGCTAAGCTGGT
CCTCTGGTTCCTACAGGCG -> CTCTGGTTCCTACAGGCGC
CCTGACGGGCGTTCGTGTG -> CTGACGGGCGTTCGTGTGA
CCTGAGAGAGCATAATGGG -> CTGAGAGAGCATAATGGGA
CCTGAGCAAAAGCAGCGGC -> CTGAGCAAAAGCAGCGGCA
CCTGATTATTTATAGATGC -> CTGATTATTTATAGATGCA
CCTGCTGGCCCGACAAGGG -> CTGCTGGCCCGACAAGGGG
CCTGGCCTAAACTTTCCAG -> CTGGCCTAAACTTTCCAGG
CCTGGCGGGTGAATCCCGC -> CTGGCGGGTGAATCCCGCC
CCTGTAATCTTCAGCAAAT -> CTGTAATCTTCAGCAAATG
CCTGTCAAAGTCTCGTGGA -> CTGTCAAAGTCTCGTGGAG
CCTTACGTATTTCGACGCT -> CTTACGTATTTCGACGCTC
CCTTATCGAGTCGGGAGGG -> CTTATCGAGTCGGGAGGGC
CCTTCGGCTACTATCTGAG -> CTTCGGCTACTATCTGAGC
CCTTGCTAAACATCTTATC -> CTTGCTAAACATCTTATCG
CCTTTGTGCTGGAAAACAC -> CTTTGTGCTGGAAAACACG
CCTTTTGATGAACATAGCT -> CTTTTGATGAACATAGCTA
CGAAAATTCCCAGGTCGTC -> GAAAATTCCCAGGTCGTCT
CGAAAGCGGCTCATGTGAA -> GAAAGCGGCTCATGTGAAG
CGAACAATCACATCTACTG -> GAACAATCACATCTACTGA
CGAACTAACAGATAACTTT -> GAACTAACAGATAACTTTC
CGAACTGGCATGCTGCACA -> GAACTGGCATGCTGCACAA
CGAAGACGACGCCATGGAT -> GAAGACGACGCCATGGATC
CGAAGCTCTTGCTGTCTCG -> GAAGCTCTTGCTGTCTCGC
CGAAGGTGGTTCTGACAGT -> GAAGGTGGTTCTGACAGTA
CGAATACCTGTCAAAGTCT -> GAATACCTGTCAAAGTCTC
CGAATTACTAAAAGTCCTC -> GAATTACTAAAAGTCCTCA
CGACAAGGGGTGAGATCGT -> GACAAGGGGTGAGATCGTT
CGACAGTCGACCGCCTCCG -> GACAGTCGACCGCCTCCGG
CGACCAGCCGGTTTACCCT -> GACCAGCCGGTTTACCCTG
CGACCGCCTCCGGTCTCAC -> GACCGCCTCCGGTCTCACT
CGACGCCATGGATCTTTGT -> GACGCCATGGATCTTTGTC
CGACGCTCTGCAGTGACCC -> GACGCTCTGCAGTGACCCC
CGACGTCCCGCGTCCGCAG -> GACGTCCCGCGTCCGCAGC
CGACTCGCGTGAACGCACA -> GACTCGCGTGAACGCACAG
CGAGACGTACAAGTCGCAG -> GAGACGTACAAGTCGCAGG
CGAGAGGCTTATCGAGTCG -> GAGAGGCTTATCGAGTCGG
CGAGATACATACAACGTCC -> GAGATACATACAACGTCCA
CGAGATCCGGCGAATACCT -> GAGATCCGGCGAATACCTG
CGAGCCGAATTACTAAAAG -> GAGCCGAATTACTAAAAGT
CGAGGGGACCAGCCGCTTC -> GAGGGGACCAGCCGCTTCG
CGAGGTTGTAAATCGCGTG -> GAGGTTGTAAATCGCGTGC
CGAGTACGTGGATGTTCGA -> GAGTACGTGGATGTTCGAG
CGAGTCGGGAGGGCAACAG -> GAGTCGGGAGGGCAACAGT
CGAGTCGGGAGGGCCCAGT -> GAGTCGGGAGGGCCCAGTC
CGAGTCGGGAGGGCTACGC -> GAGTCGGGAGGGCTACGCG
CGAGTCGGGAGGGCTAGAC -> GAGTCGGGAGGGCTAGACG
CGATCCTACTGATTTCTAA -> GATCCTACTGATTTCTAAA
CGATGGATTTCGATGGTCA -> GATGGATTTCGATGGTCAC
CGATGGTCACTGCGGGAAT -> GATGGTCACTGCGGGAATC
CGATTGTCTTCAGAACCCG -> GATTGTCTTCAGAACCCGA
CGCAACCAATATTACCCAA -> GCAACCAATATTACCCAAC
CGCACAGTGATTGGAGGGC -> GCACAGTGATTGGAGGGCG
CGCACCAAGCCGAACTGGC -> GCACCAAGCCGAACTGGCA
CGCACCCGACAGTCGACCG -> GCACCCGACAGTCGACCGC
CGCACGGATGATAGACTGC -> GCACGGATGATAGACTGCA
CGCAGACGTGCTAGATACG -> GCAGACGTGCTAGATACGT
CGCAGCCCGTCTTCTATTA -> GCAGCCCGTCTTCTATTAG
CGCAGGTCTCGCCTGCTGG -> GCAGGTCTCGCCTGCTGGC
CGCATTCCAAATCACAAGG -> GCATTCCAAATCACAAGGC
CGCCAATTAAGATAAGTCG -> GCCAATTAAGATAAGTCGT
CGCCATGGATCTTTGTCGT -> GCCATGGATCTTTGTCGTG
CGCCCAAACATAGGACCGC -> GCCCAAACATAGGACCGCG
CGCCGTACACGTGAAATCT -> GCCGTACACGTGAAATCTA
CGCCTCCGGTCTCACTCCG -> GCCTCCGGTCTCACTCCGG
CGCCTCTCACGGCTAAGCT -> GCCTCTCACGGCTAAGCTG
CGCCTGCTGGCCCGACAAG -> GCCTGCTGGCCCGACAAGG
CGCGCGCTAATCATGAAAT -> GCGCGCTAATCATGAAATA
CGCGCGTCAGAGAAGTGGG -> GCGCGTCAGAGAAGTGGGT
CGCGCTAATCATGAAATAC -> GCGCTAATCATGAAATACT
CGCGCTGCTCCTTTTGATG -> GCGCTGCTCCTTTTGATGA
CGCGGCTAAAATACCTACC -> GCGGCTAAAATACCTACCA
CGCGGCTCTGGTATATACA -> GCGGCTCTGGTATATACAA
CGCGTATTCGGGCCCCCTG -> GCGTATTCGGGCCCCCTGA
CGCGTCAGAGAAGTGGGTA -> GCGTCAGAGAAGTGGGTAG
CGCGTCCGCAGCCCGTCTT -> GCGTCCGCAGCCCGTCTTC
CGCGTCTCCTGGCGGGTGA -> GCGTCTCCTGGCGGGTGAA
CGCGTGAACGCACAGTGAT -> GCGTGAACGCACAGTGATT
CGCGTGCCACAGAGCGGGC -> GCGTGCCACAGAGCGGGCA
CGCGTGGTAGAGTAGGTTC -> GCGTGGTAGAGTAGGTTCA
CGCTAATCATGAAATACTG -> GCTAATCATGAAATACTGA
CGCTAGAGGAAGCGCCAAT -> GCTAGAGGAAGCGCCAATT
CGCTCCTCCCCATCGAAAA -> GCTCCTCCCCATCGAAAAT
CGCTCTGCAGTGACCCATA -> GCTCTGCAGTGACCCATAA
CGCTCTGCAGTGACCCCTA -> GCTCTGCAGTGACCCCTAC
CGCTCTGCAGTGACCCGTA -> GCTCTGCAGTGACCCGTAC
CGCTCTGCAGTGACCCTTG -> GCTCTGCAGTGACCCTTGC
CGCTGCTCCTTTTGATGAA -> GCTGCTCCTTTTGATGAAC
CGCTGGCTCGCTTCACTGA -> GCTGGCTCGCTTCACTGAC
CGCTTCACTGACCACGGTC -> GCTTCACTGACCACGGTCG
CGCTTCGTGCACGCGGCTC -> GCTTCGTGCACGCGGCTCT
CGCTTTAATCACAAGTCTT -> GCTTTAATCACAAGTCTTG
CGGACGCTCCTCCCCATCG -> GGACGCTCCTCCCCATCGA
CGGATGATAGACTGCATGT -> GGATGATAGACTGCATGTT
CGGCAATTCTATATCCGAA -> GGCAATTCTATATCCGAAG
CGGCAGATTGAGTGAAGAA -> GGCAGATTGAGTGAAGAAA
CGGCCCAGCATCTTTGGCG -> GGCCCAGCATCTTTGGCGT
CGGCCTAACGATTGTCTTC -> GGCCTAACGATTGTCTTCA
CGGCGAATACCTGTCAAAG -> GGCGAATACCTGTCAAAGT
CGGCGCATTCCAAATCACA -> GGCGCATTCCAAATCACAA
CGGCTAAAATACCTACCAC -> GGCTAAAATACCTACCACA
CGGCTAAGCTGGTGTCGGC -> GGCTAAGCTGGTGTCGGCA
CGGCTACTATCTGAGCTGT -> GGCTACTATCTGAGCTGTA
CGGCTCATGTGAAGGATCG -> GGCTCATGTGAAGGATCGA
CGGCTCTGGTATATACAAT -> GGCTCTGGTATATACAATA
CGGGAATCGGTAGGGCACA -> GGGAATCGGTAGGGCACAT
CGGGAGGGCAACAGTAATG -> GGGAGGGCAACAGTAATGA
CGGGAGGGCCCAGTCTCGC -> GGGAGGGCCCAGTCTCGCG
CGGGAGGGCTACGCGCTGC -> GGGAGGGCTACGCGCTGCT
CGGGAGGGCTAGACGGACG -> GGGAGGGCTAGACGGACGC
CGGGCAATCTGCTTGGACG -> GGGCAATCTGCTTGGACGC
CGGGCCCCCTGAGAGAGCA -> GGGCCCCCTGAGAGAGCAT
CGGGCGTTCGTGTGACCAC -> GGGCGTTCGTGTGACCACT
CGGGCTTAACAGAGCCGCG -> GGGCTTAACAGAGCCGCGT
CGGGGACCCTACTCCGATG -> GGGGACCCTACTCCGATGG
CGGGGGCTTTTTTGTATAG -> GGGGGCTTTTTTGTATAGA
CGGGTGAATCCCGCCTCTC -> GGGTGAATCCCGCCTCTCA
CGGTATTGTGCTCTATCAG -> GGTATTGTGCTCTATCAGG
CGGTCGTCGTAACCCCTCC -> GGTCGTCGTAACCCCTCCC
CGGTCTCACTCCGGCCTAA -> GGTCTCACTCCGGCCTAAC
CGGTGTAACCCACAAAGTA -> GGTGTAACCCACAAAGTAC
CGGTTTACCCTGGCCTAAA -> GGTTTACCCTGGCCTAAAC
CGTAACATTGGCTACGTCC -> GTAACATTGGCTACGTCCC
CGTAACCCCTCCCGCAACC -> GTAACCCCTCCCGCAACCA
CGTACAAGTCGCAGGTCTC -> GTACAAGTCGCAGGTCTCG
CGTACACGTGAAATCTAGC -> GTACACGTGAAATCTAGCT
CGTACCGAGAGGCTTATCG -> GTACCGAGAGGCTTATCGA
CGTACGAACAATCACATCT -> GTACGAACAATCACATCTA
CGTACTTGTGACGCTCTGC -> GTACTTGTGACGCTCTGCA
CGTAGCGAAAGCGGCTCAT -> GTAGCGAAAGCGGCTCATG
CGTAGTACCCAATCATGCG -> GTAGTACCCAATCATGCGG
CGTATTAGCACTCACAGCG -> GTATTAGCACTCACAGCGA
CGTATTCGGGCCCCCTGAG -> GTATTCGGGCCCCCTGAGA
CGTATTTCGACGCTCTGCA -> GTATTTCGACGCTCTGCAG
CGTCAGAGAAGTGGGTAGT -> GTCAGAGAAGTGGGTAGTC
CGTCAGCAGGATACCAAAC -> GTCAGCAGGATACCAAACA
CGTCCATAGAGCTGTGAGA -> GTCCATAGAGCTGTGAGAT
CGTCCCGACGTCCCGCGTC -> GTCCCGACGTCCCGCGTCC
CGTCCCGCGTCCGCAGCCC -> GTCCCGCGTCCGCAGCCCG
CGTCCGCAGCCCGTCTTCT -> GTCCGCAGCCCGTCTTCTA
CGTCGTAACCCCTCCCGCA -> GTCGTAACCCCTCCCGCAA
CGTCTCCGGGGACCCTACT -> GTCTCCGGGGACCCTACTC
CGTCTCCTGGCGGGTGAAT -> GTCTCCTGGCGGGTGAATC
CGTCTTCTATTAGGCTCCA -> GTCTTCTATTAGGCTCCAG
CGTGAAATCTAGCTGTTGA -> GTGAAATCTAGCTGTTGAA
CGTGAACGCACAGTGATTG -> GTGAACGCACAGTGATTGG
CGTGACGAGTACGTGGATG -> GTGACGAGTACGTGGATGT
CGTGCACGCGGCTCTGGTA -> GTGCACGCGGCTCTGGTAT
CGTGCCACAGAGCGGGCAA -> GTGCCACAGAGCGGGCAAT
CGTGCTAGATACGTTTTGC -> GTGCTAGATACGTTTTGCT
CGTGGAGAGTCCAAGTGCG -> GTGGAGAGTCCAAGTGCGA
CGTGGAGCCTAGCATCAGC -> GTGGAGCCTAGCATCAGCA
CGTGGATGTTCGAGATACA -> GTGGATGTTCGAGATACAT
CGTGGTACTAATGAGACCT -> GTGGTACTAATGAGACCTG
CGTGGTAGAGTAGGTTCAA -> GTGGTAGAGTAGGTTCAAC
CGTGTGACCACTGACTGAA -> GTGTGACCACTGACTGAAG
CGTTACTCACGCACCCGAC -> GTTACTCACGCACCCGACA
CGTTAGAACGCAGACGTGC -> GTTAGAACGCAGACGTGCT
CGTTAGCGCACCAAGCCGA -> GTTAGCGCACCAAGCCGAA
CGTTCAGCGTTAGAACGCA -> GTTCAGCGTTAGAACGCAG
CGTTCGTGTGACCACTGAC -> GTTCGTGTGACCACTGACT
CGTTGCCTTACGTATTTCG -> GTTGCCTTACGTATTTCGA
CGTTTTGCTCAGCTCAGGT -> GTTTTGCTCAGCTCAGGTG
CTAAAAGTCCTCAGCACTA -> TAAAAGTCCTCAGCACTAT
CTAAAATACCTACCACATA -> TAAAATACCTACCACATAC
CTAAACATCTTATCGAGTC -> TAAACATCTTATCGAGTCG
CTAAACTTTCCAGGCGAGG -> TAAACTTTCCAGGCGAGGT
CTAAATGACGAGCCGAATT -> TAAATGACGAGCCGAATTA
CTAACAGATAACTTTCAAT -> TAACAGATAACTTTCAATT
CTAACGATTGTCTTCAGAA -> TAACGATTGTCTTCAGAAC
CTAAGCTGGTGTCGGCAAT -> TAAGCTGGTGTCGGCAATT
CTAATCATGAAATACTGAC -> TAATCATGAAATACTGACC
CTAATGAGACCTGAGCAAA -> TAATGAGACCTGAGCAAAA
CTACAGGCCCCGTAGTACC -> TACAGGCCCCGTAGTACCC
CTACAGGCGCGCGTCAGAG -> TACAGGCGCGCGTCAGAGA
CTACCACATACGCGTATTC -> TACCACATACGCGTATTCG
CTACCATCTACCTTATCGA -> TACCATCTACCTTATCGAG
CTACCTTATCGAGTCGGGA -> TACCTTATCGAGTCGGGAG
CTACGCGCTGCTCCTTTTG -> TACGCGCTGCTCCTTTTGA
CTACGTCCCGACGTCCCGC -> TACGTCCCGACGTCCCGCG
CTACTATCTGAGCTGTAGA -> TACTATCTGAGCTGTAGAT
CTACTCCGATGGATTTCGA -> TACTCCGATGGATTTCGAT
CTACTGAAGATTAGCCCCC -> TACTGAAGATTAGCCCCCT
CTACTGATTTCTAAATGAC -> TACTGATTTCTAAATGACG
CTAGACGGACGCTCCTCCC -> TAGACGGACGCTCCTCCCC
CTAGAGGAAGCGCCAATTA -> TAGAGGAAGCGCCAATTAA
CTAGATACGTTTTGCTCAG -> TAGATACGTTTTGCTCAGC
CTAGCATCAGCAGAGGGAA -> TAGCATCAGCAGAGGGAAT
CTAGCGGCCCAGCATCTTT -> TAGCGGCCCAGCATCTTTG
CTAGCTGTTGAAGCACCAT -> TAGCTGTTGAAGCACCATA
CTATATCCGAAGCTCTTGC -> TATATCCGAAGCTCTTGCT
CTATATGATCTCCCAAATC -> TATATGATCTCCCAAATCT
CTATCACGTGGTACTAATG -> TATCACGTGGTACTAATGA
CTATCAGGTTGAGGTAAGT -> TATCAGGTTGAGGTAAGTG
CTATCATTGATACCGCGTG -> TATCATTGATACCGCGTGG
CTATCTGAGCTGTAGATGA -> TATCTGAGCTGTAGATGAT
CTATGCTTGAGCTCAAAGA -> TATGCTTGAGCTCAAAGAA
CTATGTACCAACGTACTTG -> TATGTACCAACGTACTTGT
CTATGTCTGTGGTCTCGCC -> TATGTCTGTGGTCTCGCCG
CTATTAGGCTCCAGAGAAT -> TATTAGGCTCCAGAGAATA
CTATTGTTGTCTTCATGAT -> TATTGTTGTCTTCATGATT
CTCAAAGAAGCGTTGCCTT -> TCAAAGAAGCGTTGCCTTA
CTCACAGCGAGACGTACAA -> TCACAGCGAGACGTACAAG
CTCACGCACCCGACAGTCG -> TCACGCACCCGACAGTCGA
CTCACGGCTAAGCTGGTGT -> TCACGGCTAAGCTGGTGTC
CTCACTCCGGCCTAACGAT -> TCACTCCGGCCTAACGATT
CTCAGCACTATATGATCTC -> TCAGCACTATATGATCTCC
CTCAGCTCAGGTGTCAAAA -> TCAGCTCAGGTGTCAAAAT
CTCAGGAATATATTCCACT -> TCAGGAATATATTCCACTG
CTCAGGTGTCAAAATGCTG -> TCAGGTGTCAAAATGCTGC
CTCATGGCCTTCGGCTACT -> TCATGGCCTTCGGCTACTA
CTCATGTGAAGGATCGAGG -> TCATGTGAAGGATCGAGGG
CTCCAGAGAATACTTCGGG -> TCCAGAGAATACTTCGGGG
CTCCCAAATCTACAGGCCC -> TCCCAAATCTACAGGCCCC
CTCCCCATCGAAAATTCCC -> TCCCCATCGAAAATTCCCA
CTCCCGCAACCAATATTAC -> TCCCGCAACCAATATTACC
CTCCGATGGATTTCGATGG -> TCCGATGGATTTCGATGGT
CTCCGGCCTAACGATTGTC -> TCCGGCCTAACGATTGTCT
CTCCGGGGACCCTACTCCG -> TCCGGGGACCCTACTCCGA
CTCCGGTCTCACTCCGGCC -> TCCGGTCTCACTCCGGCCT
CTCCTCCCCATCGAAAATT -> TCCTCCCCATCGAAAATTC
CTCCTGGCGGGTGAATCCC -> TCCTGGCGGGTGAATCCCG
CTCCTTTTGATGAACATAG -> TCCTTTTGATGAACATAGC
CTCGCCGTACACGTGAAAT -> TCGCCGTACACGTGAAATC
CTCGCCTGCTGGCCCGACA -> TCGCCTGCTGGCCCGACAA
CTCGCGCGCTAATCATGAA -> TCGCGCGCTAATCATGAAA
CTCGCGTGAACGCACAGTG -> TCGCGTGAACGCACAGTGA
CTCGCTGGCTCGCTTCACT -> TCGCTGGCTCGCTTCACTG
CTCGCTTCACTGACCACGG -> TCGCTTCACTGACCACGGT
CTCGTACGAACAATCACAT -> TCGTACGAACAATCACATC
CTCGTGGAGCCTAGCATCA -> TCGTGGAGCCTAGCATCAG
CTCTATCAGGTTGAGGTAA -> TCTATCAGGTTGAGGTAAG
CTCTCACGGCTAAGCTGGT -> TCTCACGGCTAAGCTGGTG
CTCTGCAGTGACCCATAAT -> TCTGCAGTGACCCATAATT
CTCTGCAGTGACCCCTACC -> TCTGCAGTGACCCCTACCA
CTCTGCAGTGACCCGTACC -> TCTGCAGTGACCCGTACCG
CTCTGCAGTGACCCTTGCT -> TCTGCAGTGACCCTTGCTA
CTCTGGTATATACAATATT -> TCTGGTATATACAATATTG
CTCTGGTTCCTACAGGCGC -> TCTGGTTCCTACAGGCGCG
CTCTTGCTGTCTCGCTGGC -> TCTTGCTGTCTCGCTGGCT
CTGAAGATAGTTCGCTTTA -> TGAAGATAGTTCGCTTTAA
CTGAAGATTAGCCCCCTCT -> TGAAGATTAGCCCCCTCTG
CTGACAGTATGCCACTCAT -> TGACAGTATGCCACTCATG
CTGACCACGGTCGTCGTAA -> TGACCACGGTCGTCGTAAC
CTGACCGAGATCCGGCGAA -> TGACCGAGATCCGGCGAAT
CTGACGGGCGTTCGTGTGA -> TGACGGGCGTTCGTGTGAC
CTGACTGAAGATAGTTCGC -> TGACTGAAGATAGTTCGCT
CTGAGAGAGCATAATGGGA -> TGAGAGAGCATAATGGGAA
CTGAGCAAAAGCAGCGGCA -> TGAGCAAAAGCAGCGGCAG
CTGAGCTGTAGATGATCAT -> TGAGCTGTAGATGATCATG
CTGATTATTTATAGATGCA -> TGATTATTTATAGATGCAT
CTGATTTCTAAATGACGAG -> TGATTTCTAAATGACGAGC
CTGCACAAACTTGGATTCC -> TGCACAAACTTGGATTCCC
CTGCAGTGACCCATAATTG -> TGCAGTGACCCATAATTGT
CTGCAGTGACCCCTACCAT -> TGCAGTGACCCCTACCATC
CTGCAGTGACCCGTACCGA -> TGCAGTGACCCGTACCGAG
CTGCAGTGACCCTTGCTAA -> TGCAGTGACCCTTGCTAAA
CTGCATGTTCCCCGGGCTT -> TGCATGTTCCCCGGGCTTA
CTGCGGGAATCGGTAGGGC -> TGCGGGAATCGGTAGGGCA
CTGCTCCTTTTGATGAACA -> TGCTCCTTTTGATGAACAT
CTGCTCGTACGAACAATCA -> TGCTCGTACGAACAATCAC
CTGCTGGCCCGACAAGGGG -> TGCTGGCCCGACAAGGGGT
CTGCTTGGACGCTCTGCAG -> TGCTTGGACGCTCTGCAGT
CTGGAAAACACGTATTAGC -> TGGAAAACACGTATTAGCA
CTGGAGCCGCCCAAACATA -> TGGAGCCGCCCAAACATAG
CTGGCATGCTGCACAAACT -> TGGCATGCTGCACAAACTT
CTGGCCCGACAAGGGGTGA -> TGGCCCGACAAGGGGTGAG
CTGGCCTAAACTTTCCAGG -> TGGCCTAAACTTTCCAGGC
CTGGCGGGTGAATCCCGCC -> TGGCGGGTGAATCCCGCCT
CTGGCTCGCTTCACTGACC -> TGGCTCGCTTCACTGACCA
CTGGTATATACAATATTGA -> TGGTATATACAATATTGAT
CTGGTGTCGGCAATTCTAT -> TGGTGTCGGCAATTCTATA
CTGGTTCCTACAGGCGCGC -> TGGTTCCTACAGGCGCGCG
CTGTAATCTTCAGCAAATG -> TGTAATCTTCAGCAAATGA
CTGTAGATGATCATGTAGA -> TGTAGATGATCATGTAGAT
CTGTCAAAGTCTCGTGGAG -> TGTCAAAGTCTCGTGGAGC
CTGTCCTGATTATTTATAG -> TGTCCTGATTATTTATAGA
CTGTCTCGCTGGCTCGCTT -> TGTCTCGCTGGCTCGCTTC
CTGTGAGATCGGTATTGTG -> TGTGAGATCGGTATTGTGC
CTGTGGTCTCGCCGTACAC -> TGTGGTCTCGCCGTACACG
CTGTTGAAGCACCATAGTT -> TGTTGAAGCACCATAGTTG
CTTAACAGAGCCGCGTCTC -> TTAACAGAGCCGCGTCTCC
CTTAATGGGGTTCTAGCGG -> TTAATGGGGTTCTAGCGGC
CTTACGTATTTCGACGCTC -> TTACGTATTTCGACGCTCT
CTTACGTCAGCAGGATACC -> TTACGTCAGCAGGATACCA
CTTATCGAGTCGGGAGGGC -> TTATCGAGTCGGGAGGGCA,TTATCGAGTCGGGAGGGCC,TTATCGAGTCGGGAGGGCT,TTATCGAGTCGGGAGGGCT
CTTCACTGACCACGGTCGT -> TTCACTGACCACGGTCGTC
CTTCAGAACCCGATCCTAC -> TTCAGAACCCGATCCTACT
CTTCAGCAAATGATATATG -> TTCAGCAAATGATATATGC
CTTCATGATTCGTTCAGCG -> TTCATGATTCGTTCAGCGT
CTTCGGCTACTATCTGAGC -> TTCGGCTACTATCTGAGCT
CTTCGGGGGCTTTTTTGTA -> TTCGGGGGCTTTTTTGTAT
CTTCGTGCACGCGGCTCTG -> TTCGTGCACGCGGCTCTGG
CTTCTATTAGGCTCCAGAG -> TTCTATTAGGCTCCAGAGA
CTTGAGCTCAAAGAAGCGT -> TTGAGCTCAAAGAAGCGTT
CTTGCTAAACATCTTATCG -> TTGCTAAACATCTTATCGA
CTTGCTGTCTCGCTGGCTC -> TTGCTGTCTCGCTGGCTCG
CTTGCTTAATGGGGTTCTA -> TTGCTTAATGGGGTTCTAG
CTTGGACGCTCTGCAGTGA -> TTGGACGCTCTGCAGTGAC
CTTGGATTCCCTTTGTGCT -> TTGGATTCCCTTTGTGCTG
CTTGTGACGCTCTGCAGTG -> TTGTGACGCTCTGCAGTGA
CTTTAATCACAAGTCTTGC -> TTTAATCACAAGTCTTGCT
CTTTCAATTGATGGAAGCT -> TTTCAATTGATGGAAGCTT
CTTTCCAGGCGAGGTTGTA -> TTTCCAGGCGAGGTTGTAA
CTTTGGCGTAGCGAAAGCG -> TTTGGCGTAGCGAAAGCGG
CTTTGTCGTGACGAGTACG -> TTTGTCGTGACGAGTACGT
CTTTGTGCTGGAAAACACG -> TTTGTGCTGGAAAACACGT
CTTTTGATGAACATAGCTA -> TTTTGATGAACATAGCTAT
CTTTTTTGTATAGACGCTC -> TTTTTTGTATAGACGCTCT
GAAAAACCAAAGGAACGAC -> AAAAACCAAAGGAACGACC
GAAAACACGTATTAGCACT -> AAAACACGTATTAGCACTC
GAAAATTCCCAGGTCGTCT -> AAAATTCCCAGGTCGTCTC
GAAAGACTATGTACCAACG -> AAAGACTATGTACCAACGT
GAAAGCGGCTCATGTGAAG -> AAAGCGGCTCATGTGAAGG
GAAATACTGACCGAGATCC -> AAATACTGACCGAGATCCG
GAAATCTAGCTGTTGAAGC -> AAATCTAGCTGTTGAAGCA
GAACAATCACATCTACTGA -> AACAATCACATCTACTGAA
GAACATAGCTATGTCTGTG -> AACATAGCTATGTCTGTGG
GAACCCGATCCTACTGATT -> AACCCGATCCTACTGATTT
GAACGACCAGCCGGTTTAC -> AACGACCAGCCGGTTTACC
GAACGCACAGTGATTGGAG -> AACGCACAGTGATTGGAGG
GAACGCAGACGTGCTAGAT -> AACGCAGACGTGCTAGATA
GAACTAACAGATAACTTTC -> AACTAACAGATAACTTTCA
GAACTGGCATGCTGCACAA -> AACTGGCATGCTGCACAAA
GAAGAAAGACTATGTACCA -> AAGAAAGACTATGTACCAA
GAAGACGACGCCATGGATC -> AAGACGACGCCATGGATCT
GAAGACTATCACGTGGTAC -> AAGACTATCACGTGGTACT
GAAGATAGTTCGCTTTAAT -> AAGATAGTTCGCTTTAATC
GAAGATTAGCCCCCTCTGG -> AAGATTAGCCCCCTCTGGT
GAAGCACCATAGTTGTCAT -> AAGCACCATAGTTGTCATC
GAAGCGCCAATTAAGATAA -> AAGCGCCAATTAAGATAAG
GAAGCGTTGCCTTACGTAT -> AAGCGTTGCCTTACGTATT
GAAGCTCTTGCTGTCTCGC -> AAGCTCTTGCTGTCTCGCT
GAAGCTTACGTCAGCAGGA -> AAGCTTACGTCAGCAGGAT
GAAGGATCGAGGGGACCAG -> AAGGATCGAGGGGACCAGC
GAAGGTGGTTCTGACAGTA -> AAGGTGGTTCTGACAGTAT
GAAGTGGGTAGTCCATTTT -> AAGTGGGTAGTCCATTTTG
GAATACCTGTCAAAGTCTC -> AATACCTGTCAAAGTCTCG
GAATACTTCGGGGGCTTTT -> AATACTTCGGGGGCTTTTT
GAATATATTCCACTGGAGC -> AATATATTCCACTGGAGCC
GAATCAGGCCTGACGGGCG -> AATCAGGCCTGACGGGCGT
GAATCCCGCCTCTCACGGC -> AATCCCGCCTCTCACGGCT
GAATTACTAAAAGTCCTCA -> AATTACTAAAAGTCCTCAG
GACAAGGGGTGAGATCGTT -> ACAAGGGGTGAGATCGTTA
GACAGTATGCCACTCATGG -> ACAGTATGCCACTCATGGC
GACAGTCGACCGCCTCCGG -> ACAGTCGACCGCCTCCGGT
GACATATCGAACTAACAGA -> ACATATCGAACTAACAGAT
GACCACGGTCGTCGTAACC -> ACCACGGTCGTCGTAACCC
GACCACTGACTGAAGATAG -> ACCACTGACTGAAGATAGT
GACCAGCCGCTTCGTGCAC -> ACCAGCCGCTTCGTGCACG
GACCAGCCGGTTTACCCTG -> ACCAGCCGGTTTACCCTGG
GACCCATAATTGTCAGCTT -> ACCCATAATTGTCAGCTTA
GACCCCTACCATCTACCTT -> ACCCCTACCATCTACCTTA
GACCCGTACCGAGAGGCTT -> ACCCGTACCGAGAGGCTTA
GACCCTACTCCGATGGATT -> ACCCTACTCCGATGGATTT
GACCCTTGCTAAACATCTT -> ACCCTTGCTAAACATCTTA
GACCGAGATCCGGCGAATA -> ACCGAGATCCGGCGAATAC
GACCGCCTCCGGTCTCACT -> ACCGCCTCCGGTCTCACTC
GACCGCGGCTAAAATACCT -> ACCGCGGCTAAAATACCTA
GACCTGAGCAAAAGCAGCG -> ACCTGAGCAAAAGCAGCGG
GACGAAGGTGGTTCTGACA -> ACGAAGGTGGTTCTGACAG
GACGACGCCATGGATCTTT -> ACGACGCCATGGATCTTTG
GACGAGCCGAATTACTAAA -> ACGAGCCGAATTACTAAAA
GACGAGTACGTGGATGTTC -> ACGAGTACGTGGATGTTCG
GACGCCATGGATCTTTGTC -> ACGCCATGGATCTTTGTCG
GACGCTCCTCCCCATCGAA -> ACGCTCCTCCCCATCGAAA
GACGCTCTGCAGTGACCCA -> ACGCTCTGCAGTGACCCAT
GACGCTCTGCAGTGACCCC -> ACGCTCTGCAGTGACCCCT
GACGCTCTGCAGTGACCCG -> ACGCTCTGCAGTGACCCGT
GACGCTCTGCAGTGACCCT -> ACGCTCTGCAGTGACCCTT
GACGGACGCTCCTCCCCAT -> ACGGACGCTCCTCCCCATC
GACGGGCGTTCGTGTGACC -> ACGGGCGTTCGTGTGACCA
GACGTACAAGTCGCAGGTC -> ACGTACAAGTCGCAGGTCT
GACGTCCCGCGTCCGCAGC -> ACGTCCCGCGTCCGCAGCC
GACGTGCTAGATACGTTTT -> ACGTGCTAGATACGTTTTG
GACTATCACGTGGTACTAA -> ACTATCACGTGGTACTAAT
GACTATGTACCAACGTACT -> ACTATGTACCAACGTACTT
GACTCGCGTGAACGCACAG -> ACTCGCGTGAACGCACAGT
GACTGAAGATAGTTCGCTT -> ACTGAAGATAGTTCGCTTT
GACTGCATGTTCCCCGGGC -> ACTGCATGTTCCCCGGGCT
GACTGTCCTGATTATTTAT -> ACTGTCCTGATTATTTATA
GAGAAGTGGGTAGTCCATT -> AGAAGTGGGTAGTCCATTT
GAGAATACTTCGGGGGCTT -> AGAATACTTCGGGGGCTTT
GAGACCTGAGCAAAAGCAG -> AGACCTGAGCAAAAGCAGC
GAGACGAAGGTGGTTCTGA -> AGACGAAGGTGGTTCTGAC
GAGACGTACAAGTCGCAGG -> AGACGTACAAGTCGCAGGT
GAGAGAGCATAATGGGAAA -> AGAGAGCATAATGGGAAAA
GAGAGCATAATGGGAAAAA -> AGAGCATAATGGGAAAAAC
GAGAGGCTTATCGAGTCGG -> AGAGGCTTATCGAGTCGGG
GAGAGTCCAAGTGCGAAGA -> AGAGTCCAAGTGCGAAGAC
GAGATACATACAACGTCCA -> AGATACATACAACGTCCAT
GAGATCCGGCGAATACCTG -> AGATCCGGCGAATACCTGT
GAGATCGGTATTGTGCTCT -> AGATCGGTATTGTGCTCTA
GAGATCGTTACTCACGCAC -> AGATCGTTACTCACGCACC
GAGCAAAAGCAGCGGCAGA -> AGCAAAAGCAGCGGCAGAT
GAGCATAATGGGAAAAACC -> AGCATAATGGGAAAAACCA
GAGCCGAATTACTAAAAGT -> AGCCGAATTACTAAAAGTC
GAGCCGCCCAAACATAGGA -> AGCCGCCCAAACATAGGAC
GAGCCGCGTCTCCTGGCGG -> AGCCGCGTCTCCTGGCGGG
GAGCCTAGCATCAGCAGAG -> AGCCTAGCATCAGCAGAGG
GAGCGGGCAATCTGCTTGG -> AGCGGGCAATCTGCTTGGA
GAGCTCAAAGAAGCGTTGC -> AGCTCAAAGAAGCGTTGCC
GAGCTGTAGATGATCATGT -> AGCTGTAGATGATCATGTA
GAGCTGTGAGATCGGTATT -> AGCTGTGAGATCGGTATTG
GAGGAAGCGCCAATTAAGA -> AGGAAGCGCCAATTAAGAT
GAGGCTTATCGAGTCGGGA -> AGGCTTATCGAGTCGGGAG
GAGGGAATCAGGCCTGACG -> AGGGAATCAGGCCTGACGG
GAGGGCAACAGTAATGACA -> AGGGCAACAGTAATGACAT
GAGGGCCCAGTCTCGCGCG -> AGGGCCCAGTCTCGCGCGC
GAGGGCGTGGAGAGTCCAA -> AGGGCGTGGAGAGTCCAAG
GAGGGCTACGCGCTGCTCC -> AGGGCTACGCGCTGCTCCT
GAGGGCTAGACGGACGCTC -> AGGGCTAGACGGACGCTCC
GAGGGGACCAGCCGCTTCG -> AGGGGACCAGCCGCTTCGT
GAGGTAAGTGTGGGGCCTA -> AGGTAAGTGTGGGGCCTAT
GAGGTTGTAAATCGCGTGC -> AGGTTGTAAATCGCGTGCC
GAGTACGTGGATGTTCGAG -> AGTACGTGGATGTTCGAGA
GAGTAGGTTCAACCTGTAA -> AGTAGGTTCAACCTGTAAT
GAGTCCAAGTGCGAAGACG -> AGTCCAAGTGCGAAGACGA
GAGTCGGGAGGGCAACAGT -> AGTCGGGAGGGCAACAGTA
GAGTCGGGAGGGCCCAGTC -> AGTCGGGAGGGCCCAGTCT
GAGTCGGGAGGGCTACGCG -> AGTCGGGAGGGCTACGCGC
GAGTCGGGAGGGCTAGACG -> AGTCGGGAGGGCTAGACGG
GAGTGAAGAAAGACTATGT -> AGTGAAGAAAGACTATGTA
GATAACTTTCAATTGATGG -> ATAACTTTCAATTGATGGA
GATAAGTCGTAACATTGGC -> ATAAGTCGTAACATTGGCT
GATACATACAACGTCCATA -> ATACATACAACGTCCATAG
GATACCAAACAGTCGACTC -> ATACCAAACAGTCGACTCG
GATACCGCGTGGTAGAGTA -> ATACCGCGTGGTAGAGTAG
GATACGTTTTGCTCAGCTC -> ATACGTTTTGCTCAGCTCA
GATAGACTGCATGTTCCCC -> ATAGACTGCATGTTCCCCG
GATAGCTATGCTTGAGCTC -> ATAGCTATGCTTGAGCTCA
GATAGTTCGCTTTAATCAC -> ATAGTTCGCTTTAATCACA
GATATATGCCCCCTATTGT -> ATATATGCCCCCTATTGTT
GATCATGTAGATTTAACCG -> ATCATGTAGATTTAACCGC
GATCCGGCGAATACCTGTC -> ATCCGGCGAATACCTGTCA
GATCCTACTGATTTCTAAA -> ATCCTACTGATTTCTAAAT
GATCGAGGGGACCAGCCGC -> ATCGAGGGGACCAGCCGCT
GATCGGTATTGTGCTCTAT -> ATCGGTATTGTGCTCTATC
GATCGGTGTAACCCACAAA -> ATCGGTGTAACCCACAAAG
GATCGTTACTCACGCACCC -> ATCGTTACTCACGCACCCG
GATCTCCCAAATCTACAGG -> ATCTCCCAAATCTACAGGC
GATCTTTGTCGTGACGAGT -> ATCTTTGTCGTGACGAGTA
GATGAACATAGCTATGTCT -> ATGAACATAGCTATGTCTG
GATGATAGACTGCATGTTC -> ATGATAGACTGCATGTTCC
GATGATCATGTAGATTTAA -> ATGATCATGTAGATTTAAC
GATGCATTTGGGAAGACTA -> ATGCATTTGGGAAGACTAT
GATGGAAGCTTACGTCAGC -> ATGGAAGCTTACGTCAGCA
GATGGATTTCGATGGTCAC -> ATGGATTTCGATGGTCACT
GATGGTCACTGCGGGAATC -> ATGGTCACTGCGGGAATCG
GATGTTCGAGATACATACA -> ATGTTCGAGATACATACAA
GATTAGCCCCCTCTGGTTC -> ATTAGCCCCCTCTGGTTCC
GATTATTTATAGATGCATT -> ATTATTTATAGATGCATTT
GATTCCCTTTGTGCTGGAA -> ATTCCCTTTGTGCTGGAAA
GATTCGTTCAGCGTTAGAA -> ATTCGTTCAGCGTTAGAAC
GATTGAGTGAAGAAAGACT -> ATTGAGTGAAGAAAGACTA
GATTGGAGGGCGTGGAGAG -> ATTGGAGGGCGTGGAGAGT
GATTGTCTTCAGAACCCGA -> ATTGTCTTCAGAACCCGAT
GATTTAACCGCACGGATGA -> ATTTAACCGCACGGATGAT
GATTTCGATGGTCACTGCG -> ATTTCGATGGTCACTGCGG
GATTTCTAAATGACGAGCC -> ATTTCTAAATGACGAGCCG
GCAAAAGCAGCGGCAGATT -> CAAAAGCAGCGGCAGATTG
GCAAATGATATATGCCCCC -> CAAATGATATATGCCCCCT
GCAACAGTAATGACATATC -> CAACAGTAATGACATATCG
GCAACCAATATTACCCAAC -> CAACCAATATTACCCAACG
GCAATCTGCTTGGACGCTC -> CAATCTGCTTGGACGCTCT
GCAATTCTATATCCGAAGC -> CAATTCTATATCCGAAGCT
GCACAAACTTGGATTCCCT -> CACAAACTTGGATTCCCTT
GCACAGTGATTGGAGGGCG -> CACAGTGATTGGAGGGCGT
GCACCAAGCCGAACTGGCA -> CACCAAGCCGAACTGGCAT
GCACCATAGTTGTCATCCA -> CACCATAGTTGTCATCCAA
GCACCCGACAGTCGACCGC -> CACCCGACAGTCGACCGCC
GCACCTCAGGAATATATTC -> CACCTCAGGAATATATTCC
GCACGCGGCTCTGGTATAT -> CACGCGGCTCTGGTATATA
GCACGGATGATAGACTGCA -> CACGGATGATAGACTGCAT
GCACTATATGATCTCCCAA -> CACTATATGATCTCCCAAA
GCACTCACAGCGAGACGTA -> CACTCACAGCGAGACGTAC
GCAGACGTGCTAGATACGT -> CAGACGTGCTAGATACGTT
GCAGAGGGAATCAGGCCTG -> CAGAGGGAATCAGGCCTGA
GCAGATTGAGTGAAGAAAG -> CAGATTGAGTGAAGAAAGA
GCAGCCCGTCTTCTATTAG -> CAGCCCGTCTTCTATTAGG
GCAGCGGCAGATTGAGTGA -> CAGCGGCAGATTGAGTGAA
GCAGGATACCAAACAGTCG -> CAGGATACCAAACAGTCGA
GCAGGATAGCTATGCTTGA -> CAGGATAGCTATGCTTGAG
GCAGGTCTCGCCTGCTGGC -> CAGGTCTCGCCTGCTGGCC
GCAGTGACCCATAATTGTC -> CAGTGACCCATAATTGTCA
GCAGTGACCCCTACCATCT -> CAGTGACCCCTACCATCTA
GCAGTGACCCGTACCGAGA -> CAGTGACCCGTACCGAGAG
GCAGTGACCCTTGCTAAAC -> CAGTGACCCTTGCTAAACA
GCATAATGGGAAAAACCAA -> CATAATGGGAAAAACCAAA
GCATCAGCAGAGGGAATCA -> CATCAGCAGAGGGAATCAG
GCATCTTTGGCGTAGCGAA -> CATCTTTGGCGTAGCGAAA
GCATGCTGCACAAACTTGG -> CATGCTGCACAAACTTGGA
GCATGTTCCCCGGGCTTAA -> CATGTTCCCCGGGCTTAAC
GCATTCCAAATCACAAGGC -> CATTCCAAATCACAAGGCA
GCATTTGGGAAGACTATCA -> CATTTGGGAAGACTATCAC
GCCAATTAAGATAAGTCGT -> CCAATTAAGATAAGTCGTA
GCCACAGAGCGGGCAATCT -> CCACAGAGCGGGCAATCTG
GCCACTCATGGCCTTCGGC -> CCACTCATGGCCTTCGGCT
GCCATGGATCTTTGTCGTG -> CCATGGATCTTTGTCGTGA
GCCCAAACATAGGACCGCG -> CCCAAACATAGGACCGCGG
GCCCAGCATCTTTGGCGTA -> CCCAGCATCTTTGGCGTAG
GCCCAGTCTCGCGCGCTAA -> CCCAGTCTCGCGCGCTAAT
GCCCCCTATTGTTGTCTTC -> CCCCCTATTGTTGTCTTCA
GCCCCCTCTGGTTCCTACA -> CCCCCTCTGGTTCCTACAG
GCCCCCTGAGAGAGCATAA -> CCCCCTGAGAGAGCATAAT
GCCCCGTAGTACCCAATCA -> CCCCGTAGTACCCAATCAT
GCCCGACAAGGGGTGAGAT -> CCCGACAAGGGGTGAGATC
GCCCGTCTTCTATTAGGCT -> CCCGTCTTCTATTAGGCTC
GCCGAACTGGCATGCTGCA -> CCGAACTGGCATGCTGCAC
GCCGAATTACTAAAAGTCC -> CCGAATTACTAAAAGTCCT
GCCGCCCAAACATAGGACC -> CCGCCCAAACATAGGACCG
GCCGCGTCTCCTGGCGGGT -> CCGCGTCTCCTGGCGGGTG
GCCGCTTCGTGCACGCGGC -> CCGCTTCGTGCACGCGGCT
GCCGGTTTACCCTGGCCTA -> CCGGTTTACCCTGGCCTAA
GCCGTACACGTGAAATCTA -> CCGTACACGTGAAATCTAG
GCCTAAACTTTCCAGGCGA -> CCTAAACTTTCCAGGCGAG
GCCTAACGATTGTCTTCAG -> CCTAACGATTGTCTTCAGA
GCCTAGCATCAGCAGAGGG -> CCTAGCATCAGCAGAGGGA
GCCTATCATTGATACCGCG -> CCTATCATTGATACCGCGT
GCCTCCGGTCTCACTCCGG -> CCTCCGGTCTCACTCCGGC
GCCTCTCACGGCTAAGCTG -> CCTCTCACGGCTAAGCTGG
GCCTGACGGGCGTTCGTGT -> CCTGACGGGCGTTCGTGTG
GCCTGCTGGCCCGACAAGG -> CCTGCTGGCCCGACAAGGG
GCCTTACGTATTTCGACGC -> CCTTACGTATTTCGACGCT
GCCTTCGGCTACTATCTGA -> CCTTCGGCTACTATCTGAG
GCGAAAGCGGCTCATGTGA -> CGAAAGCGGCTCATGTGAA
GCGAAGACGACGCCATGGA -> CGAAGACGACGCCATGGAT
GCGAATACCTGTCAAAGTC -> CGAATACCTGTCAAAGTCT
GCGAGACGTACAAGTCGCA -> CGAGACGTACAAGTCGCAG
GCGAGGTTGTAAATCGCGT -> CGAGGTTGTAAATCGCGTG
GCGCACCAAGCCGAACTGG -> CGCACCAAGCCGAACTGGC
GCGCATTCCAAATCACAAG -> CGCATTCCAAATCACAAGG
GCGCCAATTAAGATAAGTC -> CGCCAATTAAGATAAGTCG
GCGCGCGTCAGAGAAGTGG -> CGCGCGTCAGAGAAGTGGG
GCGCGCTAATCATGAAATA -> CGCGCTAATCATGAAATAC
GCGCGTCAGAGAAGTGGGT -> CGCGTCAGAGAAGTGGGTA
GCGCTAATCATGAAATACT -> CGCTAATCATGAAATACTG
GCGCTGCTCCTTTTGATGA -> CGCTGCTCCTTTTGATGAA
GCGGCAGATTGAGTGAAGA -> CGGCAGATTGAGTGAAGAA
GCGGCCCAGCATCTTTGGC -> CGGCCCAGCATCTTTGGCG
GCGGCGCATTCCAAATCAC -> CGGCGCATTCCAAATCACA
GCGGCTAAAATACCTACCA -> CGGCTAAAATACCTACCAC
GCGGCTCATGTGAAGGATC -> CGGCTCATGTGAAGGATCG
GCGGCTCTGGTATATACAA -> CGGCTCTGGTATATACAAT
GCGGGAATCGGTAGGGCAC -> CGGGAATCGGTAGGGCACA
GCGGGCAATCTGCTTGGAC -> CGGGCAATCTGCTTGGACG
GCGGGTGAATCCCGCCTCT -> CGGGTGAATCCCGCCTCTC
GCGTAGCGAAAGCGGCTCA -> CGTAGCGAAAGCGGCTCAT
GCGTATTCGGGCCCCCTGA -> CGTATTCGGGCCCCCTGAG
GCGTCAGAGAAGTGGGTAG -> CGTCAGAGAAGTGGGTAGT
GCGTCCGCAGCCCGTCTTC -> CGTCCGCAGCCCGTCTTCT
GCGTCTCCTGGCGGGTGAA -> CGTCTCCTGGCGGGTGAAT
GCGTGAACGCACAGTGATT -> CGTGAACGCACAGTGATTG
GCGTGCCACAGAGCGGGCA -> CGTGCCACAGAGCGGGCAA
GCGTGGAGAGTCCAAGTGC -> CGTGGAGAGTCCAAGTGCG
GCGTGGTAGAGTAGGTTCA -> CGTGGTAGAGTAGGTTCAA
GCGTTAGAACGCAGACGTG -> CGTTAGAACGCAGACGTGC
GCGTTCGTGTGACCACTGA -> CGTTCGTGTGACCACTGAC
GCGTTGCCTTACGTATTTC -> CGTTGCCTTACGTATTTCG
GCTAAAATACCTACCACAT -> CTAAAATACCTACCACATA
GCTAAACATCTTATCGAGT -> CTAAACATCTTATCGAGTC
GCTAAGCTGGTGTCGGCAA -> CTAAGCTGGTGTCGGCAAT
GCTAATCATGAAATACTGA -> CTAATCATGAAATACTGAC
GCTACGCGCTGCTCCTTTT -> CTACGCGCTGCTCCTTTTG
GCTACGTCCCGACGTCCCG -> CTACGTCCCGACGTCCCGC
GCTACTATCTGAGCTGTAG -> CTACTATCTGAGCTGTAGA
GCTAGACGGACGCTCCTCC -> CTAGACGGACGCTCCTCCC
GCTAGAGGAAGCGCCAATT -> CTAGAGGAAGCGCCAATTA
GCTAGATACGTTTTGCTCA -> CTAGATACGTTTTGCTCAG
GCTATGCTTGAGCTCAAAG -> CTATGCTTGAGCTCAAAGA
GCTATGTCTGTGGTCTCGC -> CTATGTCTGTGGTCTCGCC
GCTCAAAGAAGCGTTGCCT -> CTCAAAGAAGCGTTGCCTT
GCTCAGCTCAGGTGTCAAA -> CTCAGCTCAGGTGTCAAAA
GCTCAGGTGTCAAAATGCT -> CTCAGGTGTCAAAATGCTG
GCTCATGTGAAGGATCGAG -> CTCATGTGAAGGATCGAGG
GCTCCAGAGAATACTTCGG -> CTCCAGAGAATACTTCGGG
GCTCCTCCCCATCGAAAAT -> CTCCTCCCCATCGAAAATT
GCTCCTTTTGATGAACATA -> CTCCTTTTGATGAACATAG
GCTCGCTTCACTGACCACG -> CTCGCTTCACTGACCACGG
GCTCGTACGAACAATCACA -> CTCGTACGAACAATCACAT
GCTCTATCAGGTTGAGGTA -> CTCTATCAGGTTGAGGTAA
GCTCTGCAGTGACCCATAA -> CTCTGCAGTGACCCATAAT
GCTCTGCAGTGACCCCTAC -> CTCTGCAGTGACCCCTACC
GCTCTGCAGTGACCCGTAC -> CTCTGCAGTGACCCGTACC
GCTCTGCAGTGACCCTTGC -> CTCTGCAGTGACCCTTGCT
GCTCTGGTATATACAATAT -> CTCTGGTATATACAATATT
GCTCTTGCTGTCTCGCTGG -> CTCTTGCTGTCTCGCTGGC
GCTGCACAAACTTGGATTC -> CTGCACAAACTTGGATTCC
GCTGCTCCTTTTGATGAAC -> CTGCTCCTTTTGATGAACA
GCTGCTCGTACGAACAATC -> CTGCTCGTACGAACAATCA
GCTGGAAAACACGTATTAG -> CTGGAAAACACGTATTAGC
GCTGGCCCGACAAGGGGTG -> CTGGCCCGACAAGGGGTGA
GCTGGCTCGCTTCACTGAC -> CTGGCTCGCTTCACTGACC
GCTGGTGTCGGCAATTCTA -> CTGGTGTCGGCAATTCTAT
GCTGTAGATGATCATGTAG -> CTGTAGATGATCATGTAGA
GCTGTCTCGCTGGCTCGCT -> CTGTCTCGCTGGCTCGCTT
GCTGTGAGATCGGTATTGT -> CTGTGAGATCGGTATTGTG
GCTGTTGAAGCACCATAGT -> CTGTTGAAGCACCATAGTT
GCTTAACAGAGCCGCGTCT -> CTTAACAGAGCCGCGTCTC
GCTTAATGGGGTTCTAGCG -> CTTAATGGGGTTCTAGCGG
GCTTACGTCAGCAGGATAC -> CTTACGTCAGCAGGATACC
GCTTATCGAGTCGGGAGGG -> CTTATCGAGTCGGGAGGGC,CTTATCGAGTCGGGAGGGC
GCTTCACTGACCACGGTCG -> CTTCACTGACCACGGTCGT
GCTTCGTGCACGCGGCTCT -> CTTCGTGCACGCGGCTCTG
GCTTGAGCTCAAAGAAGCG -> CTTGAGCTCAAAGAAGCGT
GCTTGGACGCTCTGCAGTG -> CTTGGACGCTCTGCAGTGA
GCTTTAATCACAAGTCTTG -> CTTTAATCACAAGTCTTGC
GCTTTTTTGTATAGACGCT -> CTTTTTTGTATAGACGCTC
GGAAAAACCAAAGGAACGA -> GAAAAACCAAAGGAACGAC
GGAAAACACGTATTAGCAC -> GAAAACACGTATTAGCACT
GGAACGACCAGCCGGTTTA -> GAACGACCAGCCGGTTTAC
GGAAGACTATCACGTGGTA -> GAAGACTATCACGTGGTAC
GGAAGCGCCAATTAAGATA -> GAAGCGCCAATTAAGATAA
GGAAGCTTACGTCAGCAGG -> GAAGCTTACGTCAGCAGGA
GGAATATATTCCACTGGAG -> GAATATATTCCACTGGAGC
GGAATCAGGCCTGACGGGC -> GAATCAGGCCTGACGGGCG
GGAATCGGTAGGGCACATA -> GAATCGGTAGGGCACATAG
GGACCAGCCGCTTCGTGCA -> GACCAGCCGCTTCGTGCAC
GGACCCTACTCCGATGGAT -> GACCCTACTCCGATGGATT
GGACCGCGGCTAAAATACC -> GACCGCGGCTAAAATACCT
GGACGCTCCTCCCCATCGA -> GACGCTCCTCCCCATCGAA
GGACGCTCTGCAGTGACCC -> GACGCTCTGCAGTGACCCG
GGAGAGTCCAAGTGCGAAG -> GAGAGTCCAAGTGCGAAGA
GGAGCCGCCCAAACATAGG -> GAGCCGCCCAAACATAGGA
GGAGCCTAGCATCAGCAGA -> GAGCCTAGCATCAGCAGAG
GGAGGGCAACAGTAATGAC -> GAGGGCAACAGTAATGACA
GGAGGGCCCAGTCTCGCGC -> GAGGGCCCAGTCTCGCGCG
GGAGGGCGTGGAGAGTCCA -> GAGGGCGTGGAGAGTCCAA
GGAGGGCTACGCGCTGCTC -> GAGGGCTACGCGCTGCTCC
GGAGGGCTAGACGGACGCT -> GAGGGCTAGACGGACGCTC
GGATACCAAACAGTCGACT -> GATACCAAACAGTCGACTC
GGATAGCTATGCTTGAGCT -> GATAGCTATGCTTGAGCTC
GGATCGAGGGGACCAGCCG -> GATCGAGGGGACCAGCCGC
GGATCTTTGTCGTGACGAG -> GATCTTTGTCGTGACGAGT
GGATGATAGACTGCATGTT -> GATGATAGACTGCATGTTC
GGATGTTCGAGATACATAC -> GATGTTCGAGATACATACA
GGATTCCCTTTGTGCTGGA -> GATTCCCTTTGTGCTGGAA
GGATTTCGATGGTCACTGC -> GATTTCGATGGTCACTGCG
GGCAACAGTAATGACATAT -> GCAACAGTAATGACATATC
GGCAATCTGCTTGGACGCT -> GCAATCTGCTTGGACGCTC
GGCAATTCTATATCCGAAG -> GCAATTCTATATCCGAAGC
GGCACCTCAGGAATATATT -> GCACCTCAGGAATATATTC
GGCAGATTGAGTGAAGAAA -> GCAGATTGAGTGAAGAAAG
GGCAGGATAGCTATGCTTG -> GCAGGATAGCTATGCTTGA
GGCATGCTGCACAAACTTG -> GCATGCTGCACAAACTTGG
GGCCCAGCATCTTTGGCGT -> GCCCAGCATCTTTGGCGTA
GGCCCAGTCTCGCGCGCTA -> GCCCAGTCTCGCGCGCTAA
GGCCCCCTGAGAGAGCATA -> GCCCCCTGAGAGAGCATAA
GGCCCCGTAGTACCCAATC -> GCCCCGTAGTACCCAATCA
GGCCCGACAAGGGGTGAGA -> GCCCGACAAGGGGTGAGAT
GGCCTAAACTTTCCAGGCG -> GCCTAAACTTTCCAGGCGA
GGCCTAACGATTGTCTTCA -> GCCTAACGATTGTCTTCAG
GGCCTATCATTGATACCGC -> GCCTATCATTGATACCGCG
GGCCTGACGGGCGTTCGTG -> GCCTGACGGGCGTTCGTGT
GGCCTTCGGCTACTATCTG -> GCCTTCGGCTACTATCTGA
GGCGAATACCTGTCAAAGT -> GCGAATACCTGTCAAAGTC
GGCGAGGTTGTAAATCGCG -> GCGAGGTTGTAAATCGCGT
GGCGCATTCCAAATCACAA -> GCGCATTCCAAATCACAAG
GGCGCGCGTCAGAGAAGTG -> GCGCGCGTCAGAGAAGTGG
GGCGGGTGAATCCCGCCTC -> GCGGGTGAATCCCGCCTCT
GGCGTAGCGAAAGCGGCTC -> GCGTAGCGAAAGCGGCTCA
GGCGTGGAGAGTCCAAGTG -> GCGTGGAGAGTCCAAGTGC
GGCGTTCGTGTGACCACTG -> GCGTTCGTGTGACCACTGA
GGCTAAAATACCTACCACA -> GCTAAAATACCTACCACAT
GGCTAAGCTGGTGTCGGCA -> GCTAAGCTGGTGTCGGCAA
GGCTACGCGCTGCTCCTTT -> GCTACGCGCTGCTCCTTTT
GGCTACGTCCCGACGTCCC -> GCTACGTCCCGACGTCCCG
GGCTACTATCTGAGCTGTA -> GCTACTATCTGAGCTGTAG
GGCTAGACGGACGCTCCTC -> GCTAGACGGACGCTCCTCC
GGCTCATGTGAAGGATCGA -> GCTCATGTGAAGGATCGAG
GGCTCCAGAGAATACTTCG -> GCTCCAGAGAATACTTCGG
GGCTCGCTTCACTGACCAC -> GCTCGCTTCACTGACCACG
GGCTCTGGTATATACAATA -> GCTCTGGTATATACAATAT
GGCTTAACAGAGCCGCGTC -> GCTTAACAGAGCCGCGTCT
GGCTTATCGAGTCGGGAGG -> GCTTATCGAGTCGGGAGGG
GGCTTTTTTGTATAGACGC -> GCTTTTTTGTATAGACGCT
GGGAAAAACCAAAGGAACG -> GGAAAAACCAAAGGAACGA
GGGAAGACTATCACGTGGT -> GGAAGACTATCACGTGGTA
GGGAATCAGGCCTGACGGG -> GGAATCAGGCCTGACGGGC
GGGAATCGGTAGGGCACAT -> GGAATCGGTAGGGCACATA
GGGACCAGCCGCTTCGTGC -> GGACCAGCCGCTTCGTGCA
GGGACCCTACTCCGATGGA -> GGACCCTACTCCGATGGAT
GGGAGGGCAACAGTAATGA -> GGAGGGCAACAGTAATGAC
GGGAGGGCCCAGTCTCGCG -> GGAGGGCCCAGTCTCGCGC
GGGAGGGCTACGCGCTGCT -> GGAGGGCTACGCGCTGCTC
GGGAGGGCTAGACGGACGC -> GGAGGGCTAGACGGACGCT
GGGCAACAGTAATGACATA -> GGCAACAGTAATGACATAT
GGGCAATCTGCTTGGACGC -> GGCAATCTGCTTGGACGCT
GGGCCCAGTCTCGCGCGCT -> GGCCCAGTCTCGCGCGCTA
GGGCCCCCTGAGAGAGCAT -> GGCCCCCTGAGAGAGCATA
GGGCCTATCATTGATACCG -> GGCCTATCATTGATACCGC
GGGCGTGGAGAGTCCAAGT -> GGCGTGGAGAGTCCAAGTG
GGGCGTTCGTGTGACCACT -> GGCGTTCGTGTGACCACTG
GGGCTACGCGCTGCTCCTT -> GGCTACGCGCTGCTCCTTT
GGGCTAGACGGACGCTCCT -> GGCTAGACGGACGCTCCTC
GGGCTTAACAGAGCCGCGT -> GGCTTAACAGAGCCGCGTC
GGGCTTTTTTGTATAGACG -> GGCTTTTTTGTATAGACGC
GGGGACCAGCCGCTTCGTG -> GGGACCAGCCGCTTCGTGC
GGGGACCCTACTCCGATGG -> GGGACCCTACTCCGATGGA
GGGGCCTATCATTGATACC -> GGGCCTATCATTGATACCG
GGGGCTTTTTTGTATAGAC -> GGGCTTTTTTGTATAGACG
GGGGGCTTTTTTGTATAGA -> GGGGCTTTTTTGTATAGAC
GGGGTGAGATCGTTACTCA -> GGGTGAGATCGTTACTCAC
GGGGTTCTAGCGGCCCAGC -> GGGTTCTAGCGGCCCAGCA
GGGTAGTCCATTTTGAGAC -> GGTAGTCCATTTTGAGACG
GGGTGAATCCCGCCTCTCA -> GGTGAATCCCGCCTCTCAC
GGGTGAGATCGTTACTCAC -> GGTGAGATCGTTACTCACG
GGGTTCTAGCGGCCCAGCA -> GGTTCTAGCGGCCCAGCAT
GGTAAGTGTGGGGCCTATC -> GTAAGTGTGGGGCCTATCA
GGTACTAATGAGACCTGAG -> GTACTAATGAGACCTGAGC
GGTAGAGTAGGTTCAACCT -> GTAGAGTAGGTTCAACCTG
GGTAGTCCATTTTGAGACG -> GTAGTCCATTTTGAGACGA
GGTATATACAATATTGATC -> GTATATACAATATTGATCG
GGTATTGTGCTCTATCAGG -> GTATTGTGCTCTATCAGGT
GGTCACTGCGGGAATCGGT -> GTCACTGCGGGAATCGGTA
GGTCGTCGTAACCCCTCCC -> GTCGTCGTAACCCCTCCCG
GGTCGTCTCCGGGGACCCT -> GTCGTCTCCGGGGACCCTA
GGTCTCACTCCGGCCTAAC -> GTCTCACTCCGGCCTAACG
GGTCTCGCCGTACACGTGA -> GTCTCGCCGTACACGTGAA
GGTCTCGCCTGCTGGCCCG -> GTCTCGCCTGCTGGCCCGA
GGTGAATCCCGCCTCTCAC -> GTGAATCCCGCCTCTCACG
GGTGAGATCGTTACTCACG -> GTGAGATCGTTACTCACGC
GGTGGTTCTGACAGTATGC -> GTGGTTCTGACAGTATGCC
GGTGTAACCCACAAAGTAC -> GTGTAACCCACAAAGTACA
GGTGTCAAAATGCTGCTCG -> GTGTCAAAATGCTGCTCGT
GGTGTCGGCAATTCTATAT -> GTGTCGGCAATTCTATATC
GGTTCAACCTGTAATCTTC -> GTTCAACCTGTAATCTTCA
GGTTCCTACAGGCGCGCGT -> GTTCCTACAGGCGCGCGTC
GGTTCTAGCGGCCCAGCAT -> GTTCTAGCGGCCCAGCATC
GGTTCTGACAGTATGCCAC -> GTTCTGACAGTATGCCACT
GGTTGAGGTAAGTGTGGGG -> GTTGAGGTAAGTGTGGGGC
GGTTGTAAATCGCGTGCCA -> GTTGTAAATCGCGTGCCAC
GGTTTACCCTGGCCTAAAC -> GTTTACCCTGGCCTAAACT
GTAAATCGCGTGCCACAGA -> TAAATCGCGTGCCACAGAG
GTAACATTGGCTACGTCCC -> TAACATTGGCTACGTCCCG
GTAACCCACAAAGTACATC -> TAACCCACAAAGTACATCC
GTAACCCCTCCCGCAACCA -> TAACCCCTCCCGCAACCAA
GTAAGTGTGGGGCCTATCA -> TAAGTGTGGGGCCTATCAT
GTAATCTTCAGCAAATGAT -> TAATCTTCAGCAAATGATA
GTAATGACATATCGAACTA -> TAATGACATATCGAACTAA
GTACAAGTCGCAGGTCTCG -> TACAAGTCGCAGGTCTCGC
GTACACGTGAAATCTAGCT -> TACACGTGAAATCTAGCTG
GTACATCCGTTAGCGCACC -> TACATCCGTTAGCGCACCA
GTACCAACGTACTTGTGAC -> TACCAACGTACTTGTGACG
GTACCCAATCATGCGGCGC -> TACCCAATCATGCGGCGCA
GTACCGAGAGGCTTATCGA -> TACCGAGAGGCTTATCGAG
GTACGAACAATCACATCTA -> TACGAACAATCACATCTAC
GTACGTGGATGTTCGAGAT -> TACGTGGATGTTCGAGATA
GTACTAATGAGACCTGAGC -> TACTAATGAGACCTGAGCA
GTACTTGTGACGCTCTGCA -> TACTTGTGACGCTCTGCAG
GTAGAGTAGGTTCAACCTG -> TAGAGTAGGTTCAACCTGT
GTAGATGATCATGTAGATT -> TAGATGATCATGTAGATTT
GTAGATTTAACCGCACGGA -> TAGATTTAACCGCACGGAT
GTAGCGAAAGCGGCTCATG -> TAGCGAAAGCGGCTCATGT
GTAGGTTCAACCTGTAATC -> TAGGTTCAACCTGTAATCT
GTAGTACCCAATCATGCGG -> TAGTACCCAATCATGCGGC
GTAGTCCATTTTGAGACGA -> TAGTCCATTTTGAGACGAA
GTATAGACGCTCTGCAGTG -> TATAGACGCTCTGCAGTGA
GTATATACAATATTGATCG -> TATATACAATATTGATCGG
GTATGCCACTCATGGCCTT -> TATGCCACTCATGGCCTTC
GTATTAGCACTCACAGCGA -> TATTAGCACTCACAGCGAG
GTATTCGGGCCCCCTGAGA -> TATTCGGGCCCCCTGAGAG
GTATTGTGCTCTATCAGGT -> TATTGTGCTCTATCAGGTT
GTATTTCGACGCTCTGCAG -> TATTTCGACGCTCTGCAGT
GTCAAAATGCTGCTCGTAC -> TCAAAATGCTGCTCGTACG
GTCAAAGTCTCGTGGAGCC -> TCAAAGTCTCGTGGAGCCT
GTCACTGCGGGAATCGGTA -> TCACTGCGGGAATCGGTAG
GTCAGAGAAGTGGGTAGTC -> TCAGAGAAGTGGGTAGTCC
GTCAGCAGGATACCAAACA -> TCAGCAGGATACCAAACAG
GTCAGCTTATCGAGTCGGG -> TCAGCTTATCGAGTCGGGA
GTCATCCAAGACTGTCCTG -> TCATCCAAGACTGTCCTGA
GTCCAAGTGCGAAGACGAC -> TCCAAGTGCGAAGACGACG
GTCCATAGAGCTGTGAGAT -> TCCATAGAGCTGTGAGATC
GTCCATTTTGAGACGAAGG -> TCCATTTTGAGACGAAGGT
GTCCCGACGTCCCGCGTCC -> TCCCGACGTCCCGCGTCCG
GTCCCGCGTCCGCAGCCCG -> TCCCGCGTCCGCAGCCCGT
GTCCGCAGCCCGTCTTCTA -> TCCGCAGCCCGTCTTCTAT
GTCCTCAGCACTATATGAT -> TCCTCAGCACTATATGATC
GTCCTGATTATTTATAGAT -> TCCTGATTATTTATAGATG
GTCGACCGCCTCCGGTCTC -> TCGACCGCCTCCGGTCTCA
GTCGACTCGCGTGAACGCA -> TCGACTCGCGTGAACGCAC
GTCGCAGGTCTCGCCTGCT -> TCGCAGGTCTCGCCTGCTG
GTCGGCAATTCTATATCCG -> TCGGCAATTCTATATCCGA
GTCGGGAGGGCAACAGTAA -> TCGGGAGGGCAACAGTAAT
GTCGGGAGGGCCCAGTCTC -> TCGGGAGGGCCCAGTCTCG
GTCGGGAGGGCTACGCGCT -> TCGGGAGGGCTACGCGCTG
GTCGGGAGGGCTAGACGGA -> TCGGGAGGGCTAGACGGAC
GTCGTAACATTGGCTACGT -> TCGTAACATTGGCTACGTC
GTCGTAACCCCTCCCGCAA -> TCGTAACCCCTCCCGCAAC
GTCGTCGTAACCCCTCCCG -> TCGTCGTAACCCCTCCCGC
GTCGTCTCCGGGGACCCTA -> TCGTCTCCGGGGACCCTAC
GTCGTGACGAGTACGTGGA -> TCGTGACGAGTACGTGGAT
GTCTCACTCCGGCCTAACG -> TCTCACTCCGGCCTAACGA
GTCTCCGGGGACCCTACTC -> TCTCCGGGGACCCTACTCC
GTCTCCTGGCGGGTGAATC -> TCTCCTGGCGGGTGAATCC
GTCTCGCCGTACACGTGAA -> TCTCGCCGTACACGTGAAA
GTCTCGCCTGCTGGCCCGA -> TCTCGCCTGCTGGCCCGAC
GTCTCGCGCGCTAATCATG -> TCTCGCGCGCTAATCATGA
GTCTCGCTGGCTCGCTTCA -> TCTCGCTGGCTCGCTTCAC
GTCTCGTGGAGCCTAGCAT -> TCTCGTGGAGCCTAGCATC
GTCTGTGGTCTCGCCGTAC -> TCTGTGGTCTCGCCGTACA
GTCTTCAGAACCCGATCCT -> TCTTCAGAACCCGATCCTA
GTCTTCATGATTCGTTCAG -> TCTTCATGATTCGTTCAGC
GTCTTCTATTAGGCTCCAG -> TCTTCTATTAGGCTCCAGA
GTCTTGCTTAATGGGGTTC -> TCTTGCTTAATGGGGTTCT
GTGAAATCTAGCTGTTGAA -> TGAAATCTAGCTGTTGAAG
GTGAACGCACAGTGATTGG -> TGAACGCACAGTGATTGGA
GTGAAGAAAGACTATGTAC -> TGAAGAAAGACTATGTACC
GTGAAGGATCGAGGGGACC -> TGAAGGATCGAGGGGACCA
GTGAATCCCGCCTCTCACG -> TGAATCCCGCCTCTCACGG
GTGACCACTGACTGAAGAT -> TGACCACTGACTGAAGATA
GTGACCCATAATTGTCAGC -> TGACCCATAATTGTCAGCT
GTGACCCCTACCATCTACC -> TGACCCCTACCATCTACCT
GTGACCCGTACCGAGAGGC -> TGACCCGTACCGAGAGGCT
GTGACCCTTGCTAAACATC -> TGACCCTTGCTAAACATCT
GTGACGAGTACGTGGATGT -> TGACGAGTACGTGGATGTT
GTGACGCTCTGCAGTGACC -> TGACGCTCTGCAGTGACCC
GTGAGATCGGTATTGTGCT -> TGAGATCGGTATTGTGCTC
GTGAGATCGTTACTCACGC -> TGAGATCGTTACTCACGCA
GTGATTGGAGGGCGTGGAG -> TGATTGGAGGGCGTGGAGA
GTGCACGCGGCTCTGGTAT -> TGCACGCGGCTCTGGTATA
GTGCCACAGAGCGGGCAAT -> TGCCACAGAGCGGGCAATC
GTGCGAAGACGACGCCATG -> TGCGAAGACGACGCCATGG
GTGCTAGATACGTTTTGCT -> TGCTAGATACGTTTTGCTC
GTGCTCTATCAGGTTGAGG -> TGCTCTATCAGGTTGAGGT
GTGCTGGAAAACACGTATT -> TGCTGGAAAACACGTATTA
GTGGAGAGTCCAAGTGCGA -> TGGAGAGTCCAAGTGCGAA
GTGGAGCCTAGCATCAGCA -> TGGAGCCTAGCATCAGCAG
GTGGATGTTCGAGATACAT -> TGGATGTTCGAGATACATA
GTGGGGCCTATCATTGATA -> TGGGGCCTATCATTGATAC
GTGGGTAGTCCATTTTGAG -> TGGGTAGTCCATTTTGAGA
GTGGTACTAATGAGACCTG -> TGGTACTAATGAGACCTGA
GTGGTAGAGTAGGTTCAAC -> TGGTAGAGTAGGTTCAACC
GTGGTCTCGCCGTACACGT -> TGGTCTCGCCGTACACGTG
GTGGTTCTGACAGTATGCC -> TGGTTCTGACAGTATGCCA
GTGTAACCCACAAAGTACA -> TGTAACCCACAAAGTACAT
GTGTCAAAATGCTGCTCGT -> TGTCAAAATGCTGCTCGTA
GTGTCGGCAATTCTATATC -> TGTCGGCAATTCTATATCC
GTGTGACCACTGACTGAAG -> TGTGACCACTGACTGAAGA
GTGTGGGGCCTATCATTGA -> TGTGGGGCCTATCATTGAT
GTTACTCACGCACCCGACA -> TTACTCACGCACCCGACAG
GTTAGAACGCAGACGTGCT -> TTAGAACGCAGACGTGCTA
GTTAGCGCACCAAGCCGAA -> TTAGCGCACCAAGCCGAAC
GTTCAACCTGTAATCTTCA -> TTCAACCTGTAATCTTCAG
GTTCAGCGTTAGAACGCAG -> TTCAGCGTTAGAACGCAGA
GTTCCCCGGGCTTAACAGA -> TTCCCCGGGCTTAACAGAG
GTTCCTACAGGCGCGCGTC -> TTCCTACAGGCGCGCGTCA
GTTCGAGATACATACAACG -> TTCGAGATACATACAACGT
GTTCGCTTTAATCACAAGT -> TTCGCTTTAATCACAAGTC
GTTCGTGTGACCACTGACT -> TTCGTGTGACCACTGACTG
GTTCTAGCGGCCCAGCATC -> TTCTAGCGGCCCAGCATCT
GTTCTGACAGTATGCCACT -> TTCTGACAGTATGCCACTC
GTTGAAGCACCATAGTTGT -> TTGAAGCACCATAGTTGTC
GTTGAGGTAAGTGTGGGGC -> TTGAGGTAAGTGTGGGGCC
GTTGCCTTACGTATTTCGA -> TTGCCTTACGTATTTCGAC
GTTGTAAATCGCGTGCCAC -> TTGTAAATCGCGTGCCACA
GTTGTCATCCAAGACTGTC -> TTGTCATCCAAGACTGTCC
GTTGTCTTCATGATTCGTT -> TTGTCTTCATGATTCGTTC
GTTTACCCTGGCCTAAACT -> TTTACCCTGGCCTAAACTT
GTTTTGCTCAGCTCAGGTG -> TTTTGCTCAGCTCAGGTGT
TAAAAGTCCTCAGCACTAT -> AAAAGTCCTCAGCACTATA
TAAAATACCTACCACATAC -> AAAATACCTACCACATACG
TAAACATCTTATCGAGTCG -> AAACATCTTATCGAGTCGG
TAAACTTTCCAGGCGAGGT -> AAACTTTCCAGGCGAGGTT
TAAATCGCGTGCCACAGAG -> AAATCGCGTGCCACAGAGC
TAAATGACGAGCCGAATTA -> AAATGACGAGCCGAATTAC
TAACAGAGCCGCGTCTCCT -> AACAGAGCCGCGTCTCCTG
TAACAGATAACTTTCAATT -> AACAGATAACTTTCAATTG
TAACATTGGCTACGTCCCG -> AACATTGGCTACGTCCCGA
TAACCCACAAAGTACATCC -> AACCCACAAAGTACATCCG
TAACCCCTCCCGCAACCAA -> AACCCCTCCCGCAACCAAT
TAACCGCACGGATGATAGA -> AACCGCACGGATGATAGAC
TAACGATTGTCTTCAGAAC -> AACGATTGTCTTCAGAACC
TAACTTTCAATTGATGGAA -> AACTTTCAATTGATGGAAG
TAAGATAAGTCGTAACATT -> AAGATAAGTCGTAACATTG
TAAGCTGGTGTCGGCAATT -> AAGCTGGTGTCGGCAATTC
TAAGTCGTAACATTGGCTA -> AAGTCGTAACATTGGCTAC
TAAGTGTGGGGCCTATCAT -> AAGTGTGGGGCCTATCATT
TAATCACAAGTCTTGCTTA -> AATCACAAGTCTTGCTTAA
TAATCATGAAATACTGACC -> AATCATGAAATACTGACCG
TAATCTTCAGCAAATGATA -> AATCTTCAGCAAATGATAT
TAATGACATATCGAACTAA -> AATGACATATCGAACTAAC
TAATGAGACCTGAGCAAAA -> AATGAGACCTGAGCAAAAG
TAATGGGAAAAACCAAAGG -> AATGGGAAAAACCAAAGGA
TAATGGGGTTCTAGCGGCC -> AATGGGGTTCTAGCGGCCC
TAATTGTCAGCTTATCGAG -> AATTGTCAGCTTATCGAGT
TACAACGTCCATAGAGCTG -> ACAACGTCCATAGAGCTGT
TACAAGTCGCAGGTCTCGC -> ACAAGTCGCAGGTCTCGCC
TACAATATTGATCGGTGTA -> ACAATATTGATCGGTGTAA
TACACGTGAAATCTAGCTG -> ACACGTGAAATCTAGCTGT
TACAGGCCCCGTAGTACCC -> ACAGGCCCCGTAGTACCCA
TACAGGCGCGCGTCAGAGA -> ACAGGCGCGCGTCAGAGAA
TACATACAACGTCCATAGA -> ACATACAACGTCCATAGAG
TACATCCGTTAGCGCACCA -> ACATCCGTTAGCGCACCAA
TACCAAACAGTCGACTCGC -> ACCAAACAGTCGACTCGCG
TACCAACGTACTTGTGACG -> ACCAACGTACTTGTGACGC
TACCACATACGCGTATTCG -> ACCACATACGCGTATTCGG
TACCATCTACCTTATCGAG -> ACCATCTACCTTATCGAGT
TACCCAACGCTAGAGGAAG -> ACCCAACGCTAGAGGAAGC
TACCCAATCATGCGGCGCA -> ACCCAATCATGCGGCGCAT
TACCCTGGCCTAAACTTTC -> ACCCTGGCCTAAACTTTCC
TACCGAGAGGCTTATCGAG -> ACCGAGAGGCTTATCGAGT
TACCGCGTGGTAGAGTAGG -> ACCGCGTGGTAGAGTAGGT
TACCTACCACATACGCGTA -> ACCTACCACATACGCGTAT
TACCTGTCAAAGTCTCGTG -> ACCTGTCAAAGTCTCGTGG
TACCTTATCGAGTCGGGAG -> ACCTTATCGAGTCGGGAGG
TACGAACAATCACATCTAC -> ACGAACAATCACATCTACT
TACGCGCTGCTCCTTTTGA -> ACGCGCTGCTCCTTTTGAT
TACGCGTATTCGGGCCCCC -> ACGCGTATTCGGGCCCCCT
TACGTATTTCGACGCTCTG -> ACGTATTTCGACGCTCTGC
TACGTCAGCAGGATACCAA -> ACGTCAGCAGGATACCAAA
TACGTCCCGACGTCCCGCG -> ACGTCCCGACGTCCCGCGT
TACGTGGATGTTCGAGATA -> ACGTGGATGTTCGAGATAC
TACGTTTTGCTCAGCTCAG -> ACGTTTTGCTCAGCTCAGG
TACTAAAAGTCCTCAGCAC -> ACTAAAAGTCCTCAGCACT
TACTAATGAGACCTGAGCA -> ACTAATGAGACCTGAGCAA
TACTATCTGAGCTGTAGAT -> ACTATCTGAGCTGTAGATG
TACTCACGCACCCGACAGT -> ACTCACGCACCCGACAGTC
TACTCCGATGGATTTCGAT -> ACTCCGATGGATTTCGATG
TACTGAAGATTAGCCCCCT -> ACTGAAGATTAGCCCCCTC
TACTGACCGAGATCCGGCG -> ACTGACCGAGATCCGGCGA
TACTGATTTCTAAATGACG -> ACTGATTTCTAAATGACGA
TACTTCGGGGGCTTTTTTG -> ACTTCGGGGGCTTTTTTGT
TACTTGTGACGCTCTGCAG -> ACTTGTGACGCTCTGCAGT
TAGAACGCAGACGTGCTAG -> AGAACGCAGACGTGCTAGA
TAGACGCTCTGCAGTGACC -> AGACGCTCTGCAGTGACCC
TAGACGGACGCTCCTCCCC -> AGACGGACGCTCCTCCCCA
TAGACTGCATGTTCCCCGG -> AGACTGCATGTTCCCCGGG
TAGAGCTGTGAGATCGGTA -> AGAGCTGTGAGATCGGTAT
TAGAGGAAGCGCCAATTAA -> AGAGGAAGCGCCAATTAAG
TAGAGTAGGTTCAACCTGT -> AGAGTAGGTTCAACCTGTA
TAGATACGTTTTGCTCAGC -> AGATACGTTTTGCTCAGCT
TAGATGATCATGTAGATTT -> AGATGATCATGTAGATTTA
TAGATGCATTTGGGAAGAC -> AGATGCATTTGGGAAGACT
TAGATTTAACCGCACGGAT -> AGATTTAACCGCACGGATG
TAGCACTCACAGCGAGACG -> AGCACTCACAGCGAGACGT
TAGCATCAGCAGAGGGAAT -> AGCATCAGCAGAGGGAATC
TAGCCCCCTCTGGTTCCTA -> AGCCCCCTCTGGTTCCTAC
TAGCGAAAGCGGCTCATGT -> AGCGAAAGCGGCTCATGTG
TAGCGCACCAAGCCGAACT -> AGCGCACCAAGCCGAACTG
TAGCGGCCCAGCATCTTTG -> AGCGGCCCAGCATCTTTGG
TAGCTATGCTTGAGCTCAA -> AGCTATGCTTGAGCTCAAA
TAGCTATGTCTGTGGTCTC -> AGCTATGTCTGTGGTCTCG
TAGCTGTTGAAGCACCATA -> AGCTGTTGAAGCACCATAG
TAGGACCGCGGCTAAAATA -> AGGACCGCGGCTAAAATAC
TAGGCTCCAGAGAATACTT -> AGGCTCCAGAGAATACTTC
TAGGTTCAACCTGTAATCT -> AGGTTCAACCTGTAATCTT
TAGTACCCAATCATGCGGC -> AGTACCCAATCATGCGGCG
TAGTCCATTTTGAGACGAA -> AGTCCATTTTGAGACGAAG
TAGTTCGCTTTAATCACAA -> AGTTCGCTTTAATCACAAG
TAGTTGTCATCCAAGACTG -> AGTTGTCATCCAAGACTGT
TATACAATATTGATCGGTG -> ATACAATATTGATCGGTGT
TATAGACGCTCTGCAGTGA -> ATAGACGCTCTGCAGTGAC
TATAGATGCATTTGGGAAG -> ATAGATGCATTTGGGAAGA
TATATACAATATTGATCGG -> ATATACAATATTGATCGGT
TATATCCGAAGCTCTTGCT -> ATATCCGAAGCTCTTGCTG
TATATGATCTCCCAAATCT -> ATATGATCTCCCAAATCTA
TATATGCCCCCTATTGTTG -> ATATGCCCCCTATTGTTGT
TATATTCCACTGGAGCCGC -> ATATTCCACTGGAGCCGCC
TATCACGTGGTACTAATGA -> ATCACGTGGTACTAATGAG
TATCAGGTTGAGGTAAGTG -> ATCAGGTTGAGGTAAGTGT
TATCATTGATACCGCGTGG -> ATCATTGATACCGCGTGGT
TATCCGAAGCTCTTGCTGT -> ATCCGAAGCTCTTGCTGTC
TATCGAACTAACAGATAAC -> ATCGAACTAACAGATAACT
TATCGAGTCGGGAGGGCAA -> ATCGAGTCGGGAGGGCAAC
TATCGAGTCGGGAGGGCCC -> ATCGAGTCGGGAGGGCCCA
TATCGAGTCGGGAGGGCTA -> ATCGAGTCGGGAGGGCTAC,ATCGAGTCGGGAGGGCTAG
TATCTGAGCTGTAGATGAT -> ATCTGAGCTGTAGATGATC
TATGATCTCCCAAATCTAC -> ATGATCTCCCAAATCTACA
TATGCCACTCATGGCCTTC -> ATGCCACTCATGGCCTTCG
TATGCCCCCTATTGTTGTC -> ATGCCCCCTATTGTTGTCT
TATGCTTGAGCTCAAAGAA -> ATGCTTGAGCTCAAAGAAG
TATGTACCAACGTACTTGT -> ATGTACCAACGTACTTGTG
TATGTCTGTGGTCTCGCCG -> ATGTCTGTGGTCTCGCCGT
TATTACCCAACGCTAGAGG -> ATTACCCAACGCTAGAGGA
TATTAGCACTCACAGCGAG -> ATTAGCACTCACAGCGAGA
TATTAGGCTCCAGAGAATA -> ATTAGGCTCCAGAGAATAC
TATTCCACTGGAGCCGCCC -> ATTCCACTGGAGCCGCCCA
TATTCGGGCCCCCTGAGAG -> ATTCGGGCCCCCTGAGAGA
TATTGATCGGTGTAACCCA -> ATTGATCGGTGTAACCCAC
TATTGTGCTCTATCAGGTT -> ATTGTGCTCTATCAGGTTG
TATTGTTGTCTTCATGATT -> ATTGTTGTCTTCATGATTC
TATTTATAGATGCATTTGG -> ATTTATAGATGCATTTGGG
TATTTCGACGCTCTGCAGT -> ATTTCGACGCTCTGCAGTG
TCAAAATGCTGCTCGTACG -> CAAAATGCTGCTCGTACGA
TCAAAGAAGCGTTGCCTTA -> CAAAGAAGCGTTGCCTTAC
TCAAAGTCTCGTGGAGCCT -> CAAAGTCTCGTGGAGCCTA
TCAACCTGTAATCTTCAGC -> CAACCTGTAATCTTCAGCA
TCAATTGATGGAAGCTTAC -> CAATTGATGGAAGCTTACG
TCACAAGGCACCTCAGGAA -> CACAAGGCACCTCAGGAAT
TCACAAGTCTTGCTTAATG -> CACAAGTCTTGCTTAATGG
TCACAGCGAGACGTACAAG -> CACAGCGAGACGTACAAGT
TCACATCTACTGAAGATTA -> CACATCTACTGAAGATTAG
TCACGCACCCGACAGTCGA -> CACGCACCCGACAGTCGAC
TCACGGCTAAGCTGGTGTC -> CACGGCTAAGCTGGTGTCG
TCACGTGGTACTAATGAGA -> CACGTGGTACTAATGAGAC
TCACTCCGGCCTAACGATT -> CACTCCGGCCTAACGATTG
TCACTGACCACGGTCGTCG -> CACTGACCACGGTCGTCGT
TCACTGCGGGAATCGGTAG -> CACTGCGGGAATCGGTAGG
TCAGAACCCGATCCTACTG -> CAGAACCCGATCCTACTGA
TCAGAGAAGTGGGTAGTCC -> CAGAGAAGTGGGTAGTCCA
TCAGCAAATGATATATGCC -> CAGCAAATGATATATGCCC
TCAGCACTATATGATCTCC -> CAGCACTATATGATCTCCC
TCAGCAGAGGGAATCAGGC -> CAGCAGAGGGAATCAGGCC
TCAGCAGGATACCAAACAG -> CAGCAGGATACCAAACAGT
TCAGCGTTAGAACGCAGAC -> CAGCGTTAGAACGCAGACG
TCAGCTCAGGTGTCAAAAT -> CAGCTCAGGTGTCAAAATG
TCAGCTTATCGAGTCGGGA -> CAGCTTATCGAGTCGGGAG
TCAGGAATATATTCCACTG -> CAGGAATATATTCCACTGG
TCAGGCCTGACGGGCGTTC -> CAGGCCTGACGGGCGTTCG
TCAGGTGTCAAAATGCTGC -> CAGGTGTCAAAATGCTGCT
TCAGGTTGAGGTAAGTGTG -> CAGGTTGAGGTAAGTGTGG
TCATCCAAGACTGTCCTGA -> CATCCAAGACTGTCCTGAT
TCATGAAATACTGACCGAG -> CATGAAATACTGACCGAGA
TCATGATTCGTTCAGCGTT -> CATGATTCGTTCAGCGTTA
TCATGCGGCGCATTCCAAA -> CATGCGGCGCATTCCAAAT
TCATGGCCTTCGGCTACTA -> CATGGCCTTCGGCTACTAT
TCATGTAGATTTAACCGCA -> CATGTAGATTTAACCGCAC
TCATGTGAAGGATCGAGGG -> CATGTGAAGGATCGAGGGG
TCATTGATACCGCGTGGTA -> CATTGATACCGCGTGGTAG
TCCAAATCACAAGGCACCT -> CCAAATCACAAGGCACCTC
TCCAAGACTGTCCTGATTA -> CCAAGACTGTCCTGATTAT
TCCAAGTGCGAAGACGACG -> CCAAGTGCGAAGACGACGC
TCCACTGGAGCCGCCCAAA -> CCACTGGAGCCGCCCAAAC
TCCAGAGAATACTTCGGGG -> CCAGAGAATACTTCGGGGG
TCCAGGCGAGGTTGTAAAT -> CCAGGCGAGGTTGTAAATC
TCCATAGAGCTGTGAGATC -> CCATAGAGCTGTGAGATCG
TCCATTTTGAGACGAAGGT -> CCATTTTGAGACGAAGGTG
TCCCAAATCTACAGGCCCC -> CCCAAATCTACAGGCCCCG
TCCCAGGTCGTCTCCGGGG -> CCCAGGTCGTCTCCGGGGA
TCCCCATCGAAAATTCCCA -> CCCCATCGAAAATTCCCAG
TCCCCGGGCTTAACAGAGC -> CCCCGGGCTTAACAGAGCC
TCCCGACGTCCCGCGTCCG -> CCCGACGTCCCGCGTCCGC
TCCCGCAACCAATATTACC -> CCCGCAACCAATATTACCC
TCCCGCCTCTCACGGCTAA -> CCCGCCTCTCACGGCTAAG
TCCCGCGTCCGCAGCCCGT -> CCCGCGTCCGCAGCCCGTC
TCCCTTTGTGCTGGAAAAC -> CCCTTTGTGCTGGAAAACA
TCCGAAGCTCTTGCTGTCT -> CCGAAGCTCTTGCTGTCTC
TCCGATGGATTTCGATGGT -> CCGATGGATTTCGATGGTC
TCCGCAGCCCGTCTTCTAT -> CCGCAGCCCGTCTTCTATT
TCCGGCCTAACGATTGTCT -> CCGGCCTAACGATTGTCTT
TCCGGCGAATACCTGTCAA -> CCGGCGAATACCTGTCAAA
TCCGGGGACCCTACTCCGA -> CCGGGGACCCTACTCCGAT
TCCGGTCTCACTCCGGCCT -> CCGGTCTCACTCCGGCCTA
TCCGTTAGCGCACCAAGCC -> CCGTTAGCGCACCAAGCCG
TCCTACAGGCGCGCGTCAG -> CCTACAGGCGCGCGTCAGA
TCCTACTGATTTCTAAATG -> CCTACTGATTTCTAAATGA
TCCTCAGCACTATATGATC -> CCTCAGCACTATATGATCT
TCCTCCCCATCGAAAATTC -> CCTCCCCATCGAAAATTCC
TCCTGATTATTTATAGATG -> CCTGATTATTTATAGATGC
TCCTGGCGGGTGAATCCCG -> CCTGGCGGGTGAATCCCGC
TCCTTTTGATGAACATAGC -> CCTTTTGATGAACATAGCT
TCGAAAATTCCCAGGTCGT -> CGAAAATTCCCAGGTCGTC
TCGAACTAACAGATAACTT -> CGAACTAACAGATAACTTT
TCGACCGCCTCCGGTCTCA -> CGACCGCCTCCGGTCTCAC
TCGACGCTCTGCAGTGACC -> CGACGCTCTGCAGTGACCC
TCGACTCGCGTGAACGCAC -> CGACTCGCGTGAACGCACA
TCGAGATACATACAACGTC -> CGAGATACATACAACGTCC
TCGAGGGGACCAGCCGCTT -> CGAGGGGACCAGCCGCTTC
TCGAGTCGGGAGGGCAACA -> CGAGTCGGGAGGGCAACAG
TCGAGTCGGGAGGGCCCAG -> CGAGTCGGGAGGGCCCAGT
TCGAGTCGGGAGGGCTACG -> CGAGTCGGGAGGGCTACGC
TCGAGTCGGGAGGGCTAGA -> CGAGTCGGGAGGGCTAGAC
TCGATGGTCACTGCGGGAA -> CGATGGTCACTGCGGGAAT
TCGCAGGTCTCGCCTGCTG -> CGCAGGTCTCGCCTGCTGG
TCGCCGTACACGTGAAATC -> CGCCGTACACGTGAAATCT
TCGCCTGCTGGCCCGACAA -> CGCCTGCTGGCCCGACAAG
TCGCGCGCTAATCATGAAA -> CGCGCGCTAATCATGAAAT
TCGCGTGAACGCACAGTGA -> CGCGTGAACGCACAGTGAT
TCGCGTGCCACAGAGCGGG -> CGCGTGCCACAGAGCGGGC
TCGCTGGCTCGCTTCACTG -> CGCTGGCTCGCTTCACTGA
TCGCTTCACTGACCACGGT -> CGCTTCACTGACCACGGTC
TCGCTTTAATCACAAGTCT -> CGCTTTAATCACAAGTCTT
TCGGCAATTCTATATCCGA -> CGGCAATTCTATATCCGAA
TCGGCTACTATCTGAGCTG -> CGGCTACTATCTGAGCTGT
TCGGGAGGGCAACAGTAAT -> CGGGAGGGCAACAGTAATG
TCGGGAGGGCCCAGTCTCG -> CGGGAGGGCCCAGTCTCGC
TCGGGAGGGCTACGCGCTG -> CGGGAGGGCTACGCGCTGC
TCGGGAGGGCTAGACGGAC -> CGGGAGGGCTAGACGGACG
TCGGGCCCCCTGAGAGAGC -> CGGGCCCCCTGAGAGAGCA
TCGGGGGCTTTTTTGTATA -> CGGGGGCTTTTTTGTATAG
TCGGTATTGTGCTCTATCA -> CGGTATTGTGCTCTATCAG
TCGGTGTAACCCACAAAGT -> CGGTGTAACCCACAAAGTA
TCGTAACATTGGCTACGTC -> CGTAACATTGGCTACGTCC
TCGTAACCCCTCCCGCAAC -> CGTAACCCCTCCCGCAACC
TCGTACGAACAATCACATC -> CGTACGAACAATCACATCT
TCGTCGTAACCCCTCCCGC -> CGTCGTAACCCCTCCCGCA
TCGTCTCCGGGGACCCTAC -> CGTCTCCGGGGACCCTACT
TCGTGACGAGTACGTGGAT -> CGTGACGAGTACGTGGATG
TCGTGCACGCGGCTCTGGT -> CGTGCACGCGGCTCTGGTA
TCGTGGAGCCTAGCATCAG -> CGTGGAGCCTAGCATCAGC
TCGTGTGACCACTGACTGA -> CGTGTGACCACTGACTGAA
TCGTTACTCACGCACCCGA -> CGTTACTCACGCACCCGAC
TCGTTCAGCGTTAGAACGC -> CGTTCAGCGTTAGAACGCA
TCTAAATGACGAGCCGAAT -> CTAAATGACGAGCCGAATT
TCTACAGGCCCCGTAGTAC -> CTACAGGCCCCGTAGTACC
TCTACCTTATCGAGTCGGG -> CTACCTTATCGAGTCGGGA
TCTACTGAAGATTAGCCCC -> CTACTGAAGATTAGCCCCC
TCTAGCGGCCCAGCATCTT -> CTAGCGGCCCAGCATCTTT
TCTAGCTGTTGAAGCACCA -> CTAGCTGTTGAAGCACCAT
TCTATATCCGAAGCTCTTG -> CTATATCCGAAGCTCTTGC
TCTATCAGGTTGAGGTAAG -> CTATCAGGTTGAGGTAAGT
TCTATTAGGCTCCAGAGAA -> CTATTAGGCTCCAGAGAAT
TCTCACGGCTAAGCTGGTG -> CTCACGGCTAAGCTGGTGT
TCTCACTCCGGCCTAACGA -> CTCACTCCGGCCTAACGAT
TCTCCCAAATCTACAGGCC -> CTCCCAAATCTACAGGCCC
TCTCCGGGGACCCTACTCC -> CTCCGGGGACCCTACTCCG
TCTCCTGGCGGGTGAATCC -> CTCCTGGCGGGTGAATCCC
TCTCGCCGTACACGTGAAA -> CTCGCCGTACACGTGAAAT
TCTCGCCTGCTGGCCCGAC -> CTCGCCTGCTGGCCCGACA
TCTCGCGCGCTAATCATGA -> CTCGCGCGCTAATCATGAA
TCTCGCTGGCTCGCTTCAC -> CTCGCTGGCTCGCTTCACT
TCTCGTGGAGCCTAGCATC -> CTCGTGGAGCCTAGCATCA
TCTGACAGTATGCCACTCA -> CTGACAGTATGCCACTCAT
TCTGAGCTGTAGATGATCA -> CTGAGCTGTAGATGATCAT
TCTGCAGTGACCCATAATT -> CTGCAGTGACCCATAATTG
TCTGCAGTGACCCCTACCA -> CTGCAGTGACCCCTACCAT
TCTGCAGTGACCCGTACCG -> CTGCAGTGACCCGTACCGA
TCTGCAGTGACCCTTGCTA -> CTGCAGTGACCCTTGCTAA
TCTGCTTGGACGCTCTGCA -> CTGCTTGGACGCTCTGCAG
TCTGGTATATACAATATTG -> CTGGTATATACAATATTGA
TCTGGTTCCTACAGGCGCG -> CTGGTTCCTACAGGCGCGC
TCTGTGGTCTCGCCGTACA -> CTGTGGTCTCGCCGTACAC
TCTTATCGAGTCGGGAGGG -> CTTATCGAGTCGGGAGGGC
TCTTCAGAACCCGATCCTA -> CTTCAGAACCCGATCCTAC
TCTTCAGCAAATGATATAT -> CTTCAGCAAATGATATATG
TCTTCATGATTCGTTCAGC -> CTTCATGATTCGTTCAGCG
TCTTCTATTAGGCTCCAGA -> CTTCTATTAGGCTCCAGAG
TCTTGCTGTCTCGCTGGCT -> CTTGCTGTCTCGCTGGCTC
TCTTGCTTAATGGGGTTCT -> CTTGCTTAATGGGGTTCTA
TCTTTGGCGTAGCGAAAGC -> CTTTGGCGTAGCGAAAGCG
TCTTTGTCGTGACGAGTAC -> CTTTGTCGTGACGAGTACG
TGAAATACTGACCGAGATC -> GAAATACTGACCGAGATCC
TGAAATCTAGCTGTTGAAG -> GAAATCTAGCTGTTGAAGC
TGAACATAGCTATGTCTGT -> GAACATAGCTATGTCTGTG
TGAACGCACAGTGATTGGA -> GAACGCACAGTGATTGGAG
TGAAGAAAGACTATGTACC -> GAAGAAAGACTATGTACCA
TGAAGATAGTTCGCTTTAA -> GAAGATAGTTCGCTTTAAT
TGAAGATTAGCCCCCTCTG -> GAAGATTAGCCCCCTCTGG
TGAAGCACCATAGTTGTCA -> GAAGCACCATAGTTGTCAT
TGAAGGATCGAGGGGACCA -> GAAGGATCGAGGGGACCAG
TGAATCCCGCCTCTCACGG -> GAATCCCGCCTCTCACGGC
TGACAGTATGCCACTCATG -> GACAGTATGCCACTCATGG
TGACATATCGAACTAACAG -> GACATATCGAACTAACAGA
TGACCACGGTCGTCGTAAC -> GACCACGGTCGTCGTAACC
TGACCACTGACTGAAGATA -> GACCACTGACTGAAGATAG
TGACCCATAATTGTCAGCT -> GACCCATAATTGTCAGCTT
TGACCCCTACCATCTACCT -> GACCCCTACCATCTACCTT
TGACCCGTACCGAGAGGCT -> GACCCGTACCGAGAGGCTT
TGACCCTTGCTAAACATCT -> GACCCTTGCTAAACATCTT
TGACCGAGATCCGGCGAAT -> GACCGAGATCCGGCGAATA
TGACGAGCCGAATTACTAA -> GACGAGCCGAATTACTAAA
TGACGAGTACGTGGATGTT -> GACGAGTACGTGGATGTTC
TGACGCTCTGCAGTGACCC -> GACGCTCTGCAGTGACCCT
TGACGGGCGTTCGTGTGAC -> GACGGGCGTTCGTGTGACC
TGACTGAAGATAGTTCGCT -> GACTGAAGATAGTTCGCTT
TGAGACCTGAGCAAAAGCA -> GAGACCTGAGCAAAAGCAG
TGAGACGAAGGTGGTTCTG -> GAGACGAAGGTGGTTCTGA
TGAGAGAGCATAATGGGAA -> GAGAGAGCATAATGGGAAA
TGAGATCGGTATTGTGCTC -> GAGATCGGTATTGTGCTCT
TGAGATCGTTACTCACGCA -> GAGATCGTTACTCACGCAC
TGAGCAAAAGCAGCGGCAG -> GAGCAAAAGCAGCGGCAGA
TGAGCTCAAAGAAGCGTTG -> GAGCTCAAAGAAGCGTTGC
TGAGCTGTAGATGATCATG -> GAGCTGTAGATGATCATGT
TGAGGTAAGTGTGGGGCCT -> GAGGTAAGTGTGGGGCCTA
TGAGTGAAGAAAGACTATG -> GAGTGAAGAAAGACTATGT
TGATACCGCGTGGTAGAGT -> GATACCGCGTGGTAGAGTA
TGATAGACTGCATGTTCCC -> GATAGACTGCATGTTCCCC
TGATATATGCCCCCTATTG -> GATATATGCCCCCTATTGT
TGATCATGTAGATTTAACC -> GATCATGTAGATTTAACCG
TGATCGGTGTAACCCACAA -> GATCGGTGTAACCCACAAA
TGATCTCCCAAATCTACAG -> GATCTCCCAAATCTACAGG
TGATGAACATAGCTATGTC -> GATGAACATAGCTATGTCT
TGATGGAAGCTTACGTCAG -> GATGGAAGCTTACGTCAGC
TGATTATTTATAGATGCAT -> GATTATTTATAGATGCATT
TGATTCGTTCAGCGTTAGA -> GATTCGTTCAGCGTTAGAA
TGATTGGAGGGCGTGGAGA -> GATTGGAGGGCGTGGAGAG
TGATTTCTAAATGACGAGC -> GATTTCTAAATGACGAGCC
TGCACAAACTTGGATTCCC -> GCACAAACTTGGATTCCCT
TGCACGCGGCTCTGGTATA -> GCACGCGGCTCTGGTATAT
TGCAGTGACCCATAATTGT -> GCAGTGACCCATAATTGTC
TGCAGTGACCCCTACCATC -> GCAGTGACCCCTACCATCT
TGCAGTGACCCGTACCGAG -> GCAGTGACCCGTACCGAGA
TGCAGTGACCCTTGCTAAA -> GCAGTGACCCTTGCTAAAC
TGCATGTTCCCCGGGCTTA -> GCATGTTCCCCGGGCTTAA
TGCATTTGGGAAGACTATC -> GCATTTGGGAAGACTATCA
TGCCACAGAGCGGGCAATC -> GCCACAGAGCGGGCAATCT
TGCCACTCATGGCCTTCGG -> GCCACTCATGGCCTTCGGC
TGCCCCCTATTGTTGTCTT -> GCCCCCTATTGTTGTCTTC
TGCCTTACGTATTTCGACG -> GCCTTACGTATTTCGACGC
TGCGAAGACGACGCCATGG -> GCGAAGACGACGCCATGGA
TGCGGCGCATTCCAAATCA -> GCGGCGCATTCCAAATCAC
TGCGGGAATCGGTAGGGCA -> GCGGGAATCGGTAGGGCAC
TGCTAAACATCTTATCGAG -> GCTAAACATCTTATCGAGT
TGCTAGATACGTTTTGCTC -> GCTAGATACGTTTTGCTCA
TGCTCAGCTCAGGTGTCAA -> GCTCAGCTCAGGTGTCAAA
TGCTCCTTTTGATGAACAT -> GCTCCTTTTGATGAACATA
TGCTCGTACGAACAATCAC -> GCTCGTACGAACAATCACA
TGCTCTATCAGGTTGAGGT -> GCTCTATCAGGTTGAGGTA
TGCTGCACAAACTTGGATT -> GCTGCACAAACTTGGATTC
TGCTGCTCGTACGAACAAT -> GCTGCTCGTACGAACAATC
TGCTGGAAAACACGTATTA -> GCTGGAAAACACGTATTAG
TGCTGGCCCGACAAGGGGT -> GCTGGCCCGACAAGGGGTG
TGCTGTCTCGCTGGCTCGC -> GCTGTCTCGCTGGCTCGCT
TGCTTAATGGGGTTCTAGC -> GCTTAATGGGGTTCTAGCG
TGCTTGAGCTCAAAGAAGC -> GCTTGAGCTCAAAGAAGCG
TGCTTGGACGCTCTGCAGT -> GCTTGGACGCTCTGCAGTG
TGGAAAACACGTATTAGCA -> GGAAAACACGTATTAGCAC
TGGAAGCTTACGTCAGCAG -> GGAAGCTTACGTCAGCAGG
TGGACGCTCTGCAGTGACC -> GGACGCTCTGCAGTGACCC
TGGAGAGTCCAAGTGCGAA -> GGAGAGTCCAAGTGCGAAG
TGGAGCCGCCCAAACATAG -> GGAGCCGCCCAAACATAGG
TGGAGCCTAGCATCAGCAG -> GGAGCCTAGCATCAGCAGA
TGGAGGGCGTGGAGAGTCC -> GGAGGGCGTGGAGAGTCCA
TGGATCTTTGTCGTGACGA -> GGATCTTTGTCGTGACGAG
TGGATGTTCGAGATACATA -> GGATGTTCGAGATACATAC
TGGATTCCCTTTGTGCTGG -> GGATTCCCTTTGTGCTGGA
TGGATTTCGATGGTCACTG -> GGATTTCGATGGTCACTGC
TGGCATGCTGCACAAACTT -> GGCATGCTGCACAAACTTG
TGGCCCGACAAGGGGTGAG -> GGCCCGACAAGGGGTGAGA
TGGCCTAAACTTTCCAGGC -> GGCCTAAACTTTCCAGGCG
TGGCCTTCGGCTACTATCT -> GGCCTTCGGCTACTATCTG
TGGCGGGTGAATCCCGCCT -> GGCGGGTGAATCCCGCCTC
TGGCGTAGCGAAAGCGGCT -> GGCGTAGCGAAAGCGGCTC
TGGCTACGTCCCGACGTCC -> GGCTACGTCCCGACGTCCC
TGGCTCGCTTCACTGACCA -> GGCTCGCTTCACTGACCAC
TGGGAAAAACCAAAGGAAC -> GGGAAAAACCAAAGGAACG
TGGGAAGACTATCACGTGG -> GGGAAGACTATCACGTGGT
TGGGGCCTATCATTGATAC -> GGGGCCTATCATTGATACC
TGGGGTTCTAGCGGCCCAG -> GGGGTTCTAGCGGCCCAGC
TGGGTAGTCCATTTTGAGA -> GGGTAGTCCATTTTGAGAC
TGGTACTAATGAGACCTGA -> GGTACTAATGAGACCTGAG
TGGTAGAGTAGGTTCAACC -> GGTAGAGTAGGTTCAACCT
TGGTATATACAATATTGAT -> GGTATATACAATATTGATC
TGGTCACTGCGGGAATCGG -> GGTCACTGCGGGAATCGGT
TGGTCTCGCCGTACACGTG -> GGTCTCGCCGTACACGTGA
TGGTGTCGGCAATTCTATA -> GGTGTCGGCAATTCTATAT
TGGTTCCTACAGGCGCGCG -> GGTTCCTACAGGCGCGCGT
TGGTTCTGACAGTATGCCA -> GGTTCTGACAGTATGCCAC
TGTAAATCGCGTGCCACAG -> GTAAATCGCGTGCCACAGA
TGTAACCCACAAAGTACAT -> GTAACCCACAAAGTACATC
TGTAATCTTCAGCAAATGA -> GTAATCTTCAGCAAATGAT
TGTACCAACGTACTTGTGA -> GTACCAACGTACTTGTGAC
TGTAGATGATCATGTAGAT -> GTAGATGATCATGTAGATT
TGTAGATTTAACCGCACGG -> GTAGATTTAACCGCACGGA
TGTATAGACGCTCTGCAGT -> GTATAGACGCTCTGCAGTG
TGTCAAAATGCTGCTCGTA -> GTCAAAATGCTGCTCGTAC
TGTCAAAGTCTCGTGGAGC -> GTCAAAGTCTCGTGGAGCC
TGTCAGCTTATCGAGTCGG -> GTCAGCTTATCGAGTCGGG
TGTCATCCAAGACTGTCCT -> GTCATCCAAGACTGTCCTG
TGTCCTGATTATTTATAGA -> GTCCTGATTATTTATAGAT
TGTCGGCAATTCTATATCC -> GTCGGCAATTCTATATCCG
TGTCGTGACGAGTACGTGG -> GTCGTGACGAGTACGTGGA
TGTCTCGCTGGCTCGCTTC -> GTCTCGCTGGCTCGCTTCA
TGTCTGTGGTCTCGCCGTA -> GTCTGTGGTCTCGCCGTAC
TGTCTTCAGAACCCGATCC -> GTCTTCAGAACCCGATCCT
TGTCTTCATGATTCGTTCA -> GTCTTCATGATTCGTTCAG
TGTGAAGGATCGAGGGGAC -> GTGAAGGATCGAGGGGACC
TGTGACCACTGACTGAAGA -> GTGACCACTGACTGAAGAT
TGTGACGCTCTGCAGTGAC -> GTGACGCTCTGCAGTGACC
TGTGAGATCGGTATTGTGC -> GTGAGATCGGTATTGTGCT
TGTGCTCTATCAGGTTGAG -> GTGCTCTATCAGGTTGAGG
TGTGCTGGAAAACACGTAT -> GTGCTGGAAAACACGTATT
TGTGGGGCCTATCATTGAT -> GTGGGGCCTATCATTGATA
TGTGGTCTCGCCGTACACG -> GTGGTCTCGCCGTACACGT
TGTTCCCCGGGCTTAACAG -> GTTCCCCGGGCTTAACAGA
TGTTCGAGATACATACAAC -> GTTCGAGATACATACAACG
TGTTGAAGCACCATAGTTG -> GTTGAAGCACCATAGTTGT
TGTTGTCTTCATGATTCGT -> GTTGTCTTCATGATTCGTT
TTAACAGAGCCGCGTCTCC -> TAACAGAGCCGCGTCTCCT
TTAACCGCACGGATGATAG -> TAACCGCACGGATGATAGA
TTAAGATAAGTCGTAACAT -> TAAGATAAGTCGTAACATT
TTAATCACAAGTCTTGCTT -> TAATCACAAGTCTTGCTTA
TTAATGGGGTTCTAGCGGC -> TAATGGGGTTCTAGCGGCC
TTACCCAACGCTAGAGGAA -> TACCCAACGCTAGAGGAAG
TTACCCTGGCCTAAACTTT -> TACCCTGGCCTAAACTTTC
TTACGTATTTCGACGCTCT -> TACGTATTTCGACGCTCTG
TTACGTCAGCAGGATACCA -> TACGTCAGCAGGATACCAA
TTACTAAAAGTCCTCAGCA -> TACTAAAAGTCCTCAGCAC
TTACTCACGCACCCGACAG -> TACTCACGCACCCGACAGT
TTAGAACGCAGACGTGCTA -> TAGAACGCAGACGTGCTAG
TTAGCACTCACAGCGAGAC -> TAGCACTCACAGCGAGACG
TTAGCCCCCTCTGGTTCCT -> TAGCCCCCTCTGGTTCCTA
TTAGCGCACCAAGCCGAAC -> TAGCGCACCAAGCCGAACT
TTAGGCTCCAGAGAATACT -> TAGGCTCCAGAGAATACTT
TTATAGATGCATTTGGGAA -> TATAGATGCATTTGGGAAG
TTATCGAGTCGGGAGGGCA -> TATCGAGTCGGGAGGGCAA
TTATCGAGTCGGGAGGGCC -> TATCGAGTCGGGAGGGCCC
TTATCGAGTCGGGAGGGCT -> TATCGAGTCGGGAGGGCTA,TATCGAGTCGGGAGGGCTA
TTATTTATAGATGCATTTG -> TATTTATAGATGCATTTGG
TTCAACCTGTAATCTTCAG -> TCAACCTGTAATCTTCAGC
TTCAATTGATGGAAGCTTA -> TCAATTGATGGAAGCTTAC
TTCACTGACCACGGTCGTC -> TCACTGACCACGGTCGTCG
TTCAGAACCCGATCCTACT -> TCAGAACCCGATCCTACTG
TTCAGCAAATGATATATGC -> TCAGCAAATGATATATGCC
TTCAGCGTTAGAACGCAGA -> TCAGCGTTAGAACGCAGAC
TTCATGATTCGTTCAGCGT -> TCATGATTCGTTCAGCGTT
TTCCAAATCACAAGGCACC -> TCCAAATCACAAGGCACCT
TTCCACTGGAGCCGCCCAA -> TCCACTGGAGCCGCCCAAA
TTCCAGGCGAGGTTGTAAA -> TCCAGGCGAGGTTGTAAAT
TTCCCAGGTCGTCTCCGGG -> TCCCAGGTCGTCTCCGGGG
TTCCCCGGGCTTAACAGAG -> TCCCCGGGCTTAACAGAGC
TTCCCTTTGTGCTGGAAAA -> TCCCTTTGTGCTGGAAAAC
TTCCTACAGGCGCGCGTCA -> TCCTACAGGCGCGCGTCAG
TTCGACGCTCTGCAGTGAC -> TCGACGCTCTGCAGTGACC
TTCGAGATACATACAACGT -> TCGAGATACATACAACGTC
TTCGATGGTCACTGCGGGA -> TCGATGGTCACTGCGGGAA
TTCGCTTTAATCACAAGTC -> TCGCTTTAATCACAAGTCT
TTCGGCTACTATCTGAGCT -> TCGGCTACTATCTGAGCTG
TTCGGGCCCCCTGAGAGAG -> TCGGGCCCCCTGAGAGAGC
TTCGGGGGCTTTTTTGTAT -> TCGGGGGCTTTTTTGTATA
TTCGTGCACGCGGCTCTGG -> TCGTGCACGCGGCTCTGGT
TTCGTGTGACCACTGACTG -> TCGTGTGACCACTGACTGA
TTCGTTCAGCGTTAGAACG -> TCGTTCAGCGTTAGAACGC
TTCTAAATGACGAGCCGAA -> TCTAAATGACGAGCCGAAT
TTCTAGCGGCCCAGCATCT -> TCTAGCGGCCCAGCATCTT
TTCTATATCCGAAGCTCTT -> TCTATATCCGAAGCTCTTG
TTCTATTAGGCTCCAGAGA -> TCTATTAGGCTCCAGAGAA
TTCTGACAGTATGCCACTC -> TCTGACAGTATGCCACTCA
TTGAAGCACCATAGTTGTC -> TGAAGCACCATAGTTGTCA
TTGAGACGAAGGTGGTTCT -> TGAGACGAAGGTGGTTCTG
TTGAGCTCAAAGAAGCGTT -> TGAGCTCAAAGAAGCGTTG
TTGAGGTAAGTGTGGGGCC -> TGAGGTAAGTGTGGGGCCT
TTGAGTGAAGAAAGACTAT -> TGAGTGAAGAAAGACTATG
TTGATACCGCGTGGTAGAG -> TGATACCGCGTGGTAGAGT
TTGATCGGTGTAACCCACA -> TGATCGGTGTAACCCACAA
TTGATGAACATAGCTATGT -> TGATGAACATAGCTATGTC
TTGATGGAAGCTTACGTCA -> TGATGGAAGCTTACGTCAG
TTGCCTTACGTATTTCGAC -> TGCCTTACGTATTTCGACG
TTGCTAAACATCTTATCGA -> TGCTAAACATCTTATCGAG
TTGCTCAGCTCAGGTGTCA -> TGCTCAGCTCAGGTGTCAA
TTGCTGTCTCGCTGGCTCG -> TGCTGTCTCGCTGGCTCGC
TTGCTTAATGGGGTTCTAG -> TGCTTAATGGGGTTCTAGC
TTGGACGCTCTGCAGTGAC -> TGGACGCTCTGCAGTGACC
TTGGAGGGCGTGGAGAGTC -> TGGAGGGCGTGGAGAGTCC
TTGGATTCCCTTTGTGCTG -> TGGATTCCCTTTGTGCTGG
TTGGCGTAGCGAAAGCGGC -> TGGCGTAGCGAAAGCGGCT
TTGGCTACGTCCCGACGTC -> TGGCTACGTCCCGACGTCC
TTGGGAAGACTATCACGTG -> TGGGAAGACTATCACGTGG
TTGTAAATCGCGTGCCACA -> TGTAAATCGCGTGCCACAG
TTGTATAGACGCTCTGCAG -> TGTATAGACGCTCTGCAGT
TTGTCAGCTTATCGAGTCG -> TGTCAGCTTATCGAGTCGG
TTGTCATCCAAGACTGTCC -> TGTCATCCAAGACTGTCCT
TTGTCGTGACGAGTACGTG -> TGTCGTGACGAGTACGTGG
TTGTCTTCAGAACCCGATC -> TGTCTTCAGAACCCGATCC
TTGTCTTCATGATTCGTTC -> TGTCTTCATGATTCGTTCA
TTGTGACGCTCTGCAGTGA -> TGTGACGCTCTGCAGTGAC
TTGTGCTCTATCAGGTTGA -> TGTGCTCTATCAGGTTGAG
TTGTGCTGGAAAACACGTA -> TGTGCTGGAAAACACGTAT
TTGTTGTCTTCATGATTCG -> TGTTGTCTTCATGATTCGT
TTTAACCGCACGGATGATA -> TTAACCGCACGGATGATAG
TTTAATCACAAGTCTTGCT -> TTAATCACAAGTCTTGCTT
TTTACCCTGGCCTAAACTT -> TTACCCTGGCCTAAACTTT
TTTATAGATGCATTTGGGA -> TTATAGATGCATTTGGGAA
TTTCAATTGATGGAAGCTT -> TTCAATTGATGGAAGCTTA
TTTCCAGGCGAGGTTGTAA -> TTCCAGGCGAGGTTGTAAA
TTTCGACGCTCTGCAGTGA -> TTCGACGCTCTGCAGTGAC
TTTCGATGGTCACTGCGGG -> TTCGATGGTCACTGCGGGA
TTTCTAAATGACGAGCCGA -> TTCTAAATGACGAGCCGAA
TTTGAGACGAAGGTGGTTC -> TTGAGACGAAGGTGGTTCT
TTTGATGAACATAGCTATG -> TTGATGAACATAGCTATGT
TTTGCTCAGCTCAGGTGTC -> TTGCTCAGCTCAGGTGTCA
TTTGGCGTAGCGAAAGCGG -> TTGGCGTAGCGAAAGCGGC
TTTGGGAAGACTATCACGT -> TTGGGAAGACTATCACGTG
TTTGTATAGACGCTCTGCA -> TTGTATAGACGCTCTGCAG
TTTGTCGTGACGAGTACGT -> TTGTCGTGACGAGTACGTG
TTTGTGCTGGAAAACACGT -> TTGTGCTGGAAAACACGTA
TTTTGAGACGAAGGTGGTT -> TTTGAGACGAAGGTGGTTC
TTTTGATGAACATAGCTAT -> TTTGATGAACATAGCTATG
TTTTGCTCAGCTCAGGTGT -> TTTGCTCAGCTCAGGTGTC
TTTTGTATAGACGCTCTGC -> TTTGTATAGACGCTCTGCA
TTTTTGTATAGACGCTCTG -> TTTTGTATAGACGCTCTGC
TTTTTTGTATAGACGCTCT -> TTTTTGTATAGACGCTCTG
